........................SSCLLLLLLLLLLLLLLLLLLLLLLLLLLLLLLLLLLLLLLLLLLLLLLLLLLLLLLLLLLLLLLLLLLLLLLLLLLLLCCSSSSS..................
.........................SCLLLLLLLLLLLLLLLLLLLLLLLLLLLLLLLLLLLLLLLLLLLLLLLLLLLLLLLLLLLLLLLLLLLLLLLLLLLLLCCSSSS..................
.........................SCLLLLLLLLLLLLLLLLLLLLLLLLLLLLLLLLLLLLLLLLLLLLLLLLLLLLLLLLLLLLLLLLLLLLLLLLLLLLLLCCCSS..................
.........................SCLLLLLLLLLLLLLLLLLLLLLLLLLLLLLLLLLLLLLLLLLLLLLLLLLLLLLLLLLLLLLLLLLLLLLLLLLLLLLLLLLCSS.................
.........................SSCLLLLLLLLLLLLLLLLLLLLLLLLLLLLLLLLLLLLLLLLLLLLLLLLLLLLLLLLLLLLLLLLLLLLLLLLLLLLLLLLLCSS................
..........................SCCLLCCCCCLLLLLLLLLLLLLLLLLLLLLLLLLLLLLLLLLLLLLLLLLLLLLLLLLLLLLLLLLLLLLLLLLLLLLLLLLLCS................
..........................SSCCCSSSSCLLLLLLLLLLLLLLLLLLLLLLLLLLLLLLLLLLLLLLLLLLLLLLLLLLLLLLLLLLLLLLLLLLLLLLLLLLCS................
............................SSSS..SSCCCLLLLLLLLLLLLLLLLLLLLLLLLLLLLLLLLLLLLLLLLLLLLLLLLLLLLLLLLLLLLLLLLLLLLLLCCS................
...................................SSSSCLLLLLLLLLLLLLLLLLLLLLLLLLLLLLLLLLLLLLLLLLLLLLLLLLLLLLLLLLLLLLLLLLLLLLCS.................
.....................................SSCCLLLLLLLLLLLLLLLLLLLLLLLLLLLLLLLLLLLLLLLLLLLLLLLLLLLLLLLLLLLLLLLLCCCSSS.................
......................................SSSCCLLLLLLLLLLLLLLLLLLLLLLLLLLLLLLLLLLLLLLLLLLLLLLLLLLLLLLLLLLLLLLCSSSS..................
........................................SSCCLLLLLLLLLLLLLLLLLLLLLLLLLLLLLLLLLLLLLLLLLLLLLLLLLLLLLLLLLLLLLCS.....................
.........................................SSSCLLLLLLLLLLLLLLLLLLLLLLLLLLLLLLLLLLLLLLLLLLLLLLLLLLLLLLLLLLCCCS.....................
..........................................SSSCCLLLLLLLLLLLLLLLLLLLLLLLLLLLLLLLLLLLLLLLLLLLLLLLLLLLLLLLCCSSS.....................
............................................SSCCCLLLLLLLLLLLLLLLLLLLLLLLLLLLLLLLLLLLLLLLLLLLLLLLLLLLLCCSSSS.....................
.............................................SSSSSCCCCCLLLLLLLLLLLLLLLLLLLLLLLLLLLLLLLLLLLLLLLLLLLLLLCSS........................
..............................................SSSSSSSSCCCCLLLLLLLLLLLLLLLLLLLLLLLLLLLLLLLLLLLLLLLLLLLCSS........................
....................................................SSSSSCLLLLLLLLLLLLLLLLLLLLLLLLLLLLLLLLLLLLLLLLLLLCS.........................
......................................................SSSSCCCCLLLLLLLLLLLLLLLLLLLLLLLLLLLLLLLLLLLLLLLCS.........................
.........................................................SSSSSCLLLLLLLLLLLLLLLLLLLLLLLLLLLLLLLLLLLLCCSS.........................
...........................................................SSSSCCLLLLLLLLLLLLLLLLLLLLLLLLLLLLLLLLLCCSSS.........................
.............................................................SSSSCLLLLLLLLLLLLLLLLLLLLLLLLLLLLLLLLLCSS..........................
..............................................................SSSCLLLLLLLLLLLLLLLLLLLLLLLLLLLLLLLLLCCS..........................
...............................................................SSCLLLLLLLLLLLLLLLLLLLLLLLLLLLLLLLLLLCSS.........................
...............................................................SSCLLLLLLLLLLLLLLLLLLLLLLLLLLLLLLLLLLCSS.........................
...............................................................SSSCLLLLLLLLLLLLLLLLLLLLLLLLLLLLLLLLLCSS.........................
...............................................................SSSSCLLLLLLLLLLLLLLLLLLLLLLLLLLLLLLLLCSS.........................
................................................................SSSSCLLLLLLLLLLLLLLLLLLLLLLLLLLLLLLLCSS.........................
..................................................................SSSCCLLLLLLLLLLLLLLLLLLLLLLLLLLLLLCSS.........................
...................................................................SSSSSCLLLLLLLLLLLLLLLLLLLLLLLLLLLCSS.........................
....................................................................SSSSCLLLLLLLLLLLLLLLLLLLLLLLLLLCSS..........................
......................................................................SSCLLLLLLLLLLLLLLLLLLLLLLLLLCSSS..........................
......................................................................SSCCLLLLLLLLLLLLLLLLLLLCCCCCCSSS..........................
......................................................................SSSCCLLLLLLLLLLLLLLLCCCCSSSSSSS...........................
.......................................................................SSSCCLLLLLLLLLLLLLCSSSSSSSSSS............................
........................................................................SSSCCLLLLLLLLLLLCSSSSSS.................................
.........................................................................SSSCCLLLLLLLCCCSSS.....................................
..........................................................................SSSSCCCCCCCSSSSSS.....................................
...........................................................................SSSSSSSSSSSSSSS......................................
.............................................................................SSSSSSSSS..........................................
................................................................................SSSS............................................
................................................................................................................................
................................................................................................................................
................................................................................................................................
................................................................................................................................
..............................................................OOOO..OOO.O..O.O...O.OOOO.OOOO....................................
..............................................................O....O....O..O.OO..O.O....O.......................................
..............................................................OOOO.O....OOOO.O.O.O.OOOO.OOOO....................................
.................................................................O.O....O..O.O..OO.O....O.......................................
..............................................................OOOO..OOO.O..O.O...O.OOOO.OOOO....................................
................................................................................................................................
................................................................................................................................
................................................................................................................................
................................................................................................................................
.......................................................................SSSS.....................................................
......................................................................SSCCSSS...................................................
.....................................................................SCCLCSSS...................................................
...........................................................SSSSSS..SSCCLLLSSS...................................................
.........................................................SSSSSSSSSSSCLLLLLSSS...................................................
........................................................SSSSCCCCCCCCLLLLLLSSSS..................................................
.....................................................S.SSCCLLLLLLLLLLLLLLLCSSSSSS...............................................
.....................................................SSSSCLLLLLLLLLLLLLLLLCCCCCCS...............................................
....................................................SSSCCLLLLLLLLLLLLLLLLLLLLLLCCS..............................................
....................................................SSCCLLLLLLLLLLLLLLLLLLLLLLLLCS..............................................
....................................................SCCCCLLLLLLLLLLLLLLLLLLLLLLLCS..............................................
.................................................SSSSCLLLLLLLLLLLLLLLLLLLLLLLLLLCSS.............................................
................................................SSCCCLLLLLLLLLLLLLLLLLLLLLLLLLLLCSSS............................................
...............................................SCCLLLLLLLLLLLLLLLLLLLLLLLLLLLLLLLCSS............................................
..............................................SSCLLLLLLLLLLLLLLLLLLLLLLLLLLLLLLLLCCSSS..........................................
..............................................SCLLLLLLLLLLLLLLLLLLLLLLLLLLLLLLLLLLCCSSS.........................................
..............................................SCLLLLLLLLLLLLLLLLLLLLLLLLLLLLLLLLLLLCCSS.........................................
..............................................SCLLLLLLLLLLLLLLLLLLLLLLLLLLLLLLLLLLCCCSS.........................................
.............................................SSCLLLLLLLLLLLLLLLLLLLLLLLLLLLLLLLLLLLLCSS.........................................
..........................................SSSSCLLLLLLLLLLLLLLLLLLLLLLLLLLLLLLLLLLLLLLCSS........................................
...................................SSSSSSSSCCCLLLLLLLLLLLLLLLLLLLLLLLLLLLLLLLLLLLLLLLCSS........................................
.................................SSCCCCCCCCLLLLLLLLLLLLLLLLLLLLLLLLLLLLLLLLLLLLLLLLLLCSS........................................
................................SSCLLLLLLLLLLLLLLLLLLLLLLLLLLLLLLLLLLLLLLLLLLLLLLLLLLCSS........................................
...............................SSCLLLLLLLLLLLLLLLLLLLLLLLLLLLLLLLLLLLLLLLLLLLLLLLLLLLCSS........................................
..............................SCCCLLLLLLLLLLLLLLLLLLLLLLLLLLLLLLLLLLLLLLLLLLLLLLLLLLLCSS........................................
.............................SCCLLLLLLLLLLLLLLLLLLLLLLLLLLLLLLLLLLLLLLLLLLLLLLLLLLLLLCSS........................................
............................SSCLLLLLLLLLLLLLLLLLLLLLLLLLLLLLLLLLLLLLLLLLLLLLLLLLLLLLLCSSS.......................................
...........................SSCCLLLLLLLLLLLLLLLLLLLLLLLLLLLLLLLLLLLLLLLLLLLLLLLLLLLLLLLCSS.......................................
..........................SSSCLLLLLLLLLLLLLLLLLLLLLLLLLLLLLLLLLLLLLLLLLLLLLLLLLLLLLLLLCSS.......................................
.........................SSSCLLLLLLLLLLLLLLLLLLLLLLLLLLLLLLLLLLLLLLLLLLLLLLLLLLLLLLLLLCSSS......................................
........................SSCCLLLLLLLLLLLLLLLLLLLLLLLLLLLLLLLLLLLLLLLLLLLLLLLLLLLLLLLLLLLCSS......................................
.......................SSCLLLLLLLLLLLLLLLLLLLLLLLLLLLLLLLLLLLLLLLLLLLLLLLLLLLLLLLLLLLLLCSS......................................
.......................SCLLLLLLLLLLLLLLLLLLLLLLLLLLLLLLLLLLLLLLLLLLLLLLLLLLLLLLLLLLLLLLLSS......................................
......................SSCLLLLLLLLLLLLLLLLLLLLLLLLLLLLLLLLLLLLLLLLLLLLLLLLLLLLLLLLLLLLLLCSS......................................
......................SSLLLLLLLLLLLLLLLLLLLLLLLLLLLLLLLLLLLLLLLLLLLLLLLLLLLLLLLLLLLLLLLCSS......................................
......................SSLLLLLLLLLLLLLLLLLLLLLLLLLLLLLLLLLLLLLLLLLLLLLLLLLLLLLLLLLLLLLLLCSS......................................
......................SSLLLLLLLLLLLLLLLLLLLLLLLLLLLLLLLLLLLLLLLLLLLLLLLLLLLLLLLLLLLLLLLCSS......................................
......................SSLLLLLLLLLLLLLLLLLLLLLLLLLLLLLLLLLLLLLLLLLLLLLLLLLLLLLLLLLLLLLLLCSS......................................
......................SSLLLLLLLLLLLLLLLLLLLLLLLLLLLLLLLLLLLLLLLLLLLLLLLLLLLLLLLLLLLLLLLLCS......................................
.SSS..................SSCCLLLLLLLLLLLLLLLLLLLLLLLLLLLLLLLLLLLLLLLLLLLLLLLLLLLLLLLLLLLLLLCS......................................
SCCSS..SSSS..........S.SSCLLLLLLLLLLLLLLLLLLLLLLLLLLLLLLLLLLLLLLLLLLLLLLLLLLLLLLLLLLLLLLCS......................................
LLLCCSSSCCCS.........SSSCCLLLLLLLLLLLLLLLLLLLLLLLLLLLLLLLLLLLLLLLLLLLLLLLLLLLLLLLLLLLLLCSS......................................
LLLLCCCCLLCCS........SSCLLLLLLLLLLLLLLLLLLLLLLLLLLLLLLLLLLLLLLLLLLLLLLLLLLLLLLLLLLLLLLCCS.......................................
LLLLLLLLLLLCSS......SSCLLLLLLLLLLLLLLLLLLLLLLLLLLLLLLLLLLLLLLLLLLLLLLLLLLLLLLLLLLLLLLLCS........................................
LLLLLLLLLLLCCSS...SSSSCLLLLLLLLLLLLLLLLLLLLLLLLLLLLLLLLLLLLLLLLLLLLLLLLLLLLLLLLLLLLLLLSS........................................
LLLLLLLLLLLLCCCS.SSSSCLLLLLLLLLLLLLLLLLLLLLLLLLLLLLLLLLLLLLLLLLLLLLLLLLLLLLLLLLLLLLLLCSS........................................
LLLLLLLLLLLLLLCSSSCCLLLLLLLLLLLLLLLLLLLLLLLLLLLLLLLLLLLLLLLLLLLLLLLLLLLLLLLLLLLLLLLLLCSS........................................
LLLLLLLLLLLLLLCCCCLLLLLLLLLLLLLLLLLLLLLLLLLLLLLLLLLLLLLLLLLLLLLLLLLLLLLLLLLLLLLLLLLLCSS.........................................
LLLLLLLLLLLLLLLLLLLLLLLLLLLLLLLLLLLLLLLLLLLLLLLLLLLLLLLLLLLLLLLLLLLLLLLLLLLLLLLLLLLLCSS.........................................
LLLLLLLLLLLLLLLLLLLLLLLLLLLLLLLLLLLLLLLLLLLLLLLLLLLLLLLLLLLLLLLLLLLLLLLLLLLLLLLLLLLLCSS.........................................
LLLLLLLLLLLLLLLLLLLLLLLLLLLLLLLLLLLLLLLLLLLLLLLLLLLLLLLLLLLLLLLLLLLLLLLLLLLLLLLLLLLLCSS.........................................
LLLLLLLLLLLLLLLLLLLLLLLLLLLLLLLLLLLLLLLLLLLLLLLLLLLLLLLLLLLLLLLLLLLLLLLLLLLLLLLLLLLLCSS.........................................
LLLLLLLLLLLLLLLLLLLLLLLLLLLLLLLLLLLLLLLLLLLLLLLLLLLLLLLLLLLLLLLLLLLLLLLLLLLLLLLLLLLLCSS.........................................
LLLLLLLLLLLLLLLLLLLLLLLLLLLLLLLLLLLLLLLLLLLLLLLLLLLLLLLLLLLLLLLLLLLLLLLLLLLLLLLLLLLLCCS.........................................
LLLLLLLLLLLLLLLLLLLLLLLLLLLLLLLLLLLLLLLLLLLLLLLLLLLLLLLLLLLLLLLLLLLLLLLLLLLLLLLLLLLLLCS.........................................
LLLLLLLLLLLLLLLLLLLLLLLLLLLLLLLLLLLLLLLLLLLLLLLLLLLLLLLLLLLLLLLLLLLLLLLLLLLLLLLLLLLLLCCS........................................
LLLLLLLLLLLLLLLLLLLLLLLLLLLLLLLLLLLLLLLLLLLLLLLLLLLLLLLLLLLLLLLLLLLLLLLLLLLLLLLLLLLLLLCSSSS.....................................
LLLLLLLLLLLLLLLLLLLLLLLLLLLLLLLLLLLLLLLLLLLLLLLLLLLLLLLLLLLLLLLLLLLLLLLLLLLLLLLLLLLLLLCCSSS.....................................
LLLLLLLLLLLLLLLLLLLLLLLLLLLLLLLLLLLLLLLLLLLLLLLLLLLLLLLLLLLLLLLLLLLLLLLLLLLLLLLLLLLLLLLLCSS.....................................
LLLLLLLLLLLLLLLLLLLLLLLLLLLLLLLLLLLLLLLLLLLLLLLLLLLLLLLLLLLLLLLLLLLLLLLLLLLLLLLLLLLLLLLLLCS.....................................
LLLLLLLLLLLLLLLLLLLLLLLLLLLLLLLLLLLLLLLLLLLLLLLLLLLLLLLLLLLLLLLLLLLLLLLLLLLLLLLLLLLLLLLLLCS.....................................
LLLLLLLLLLLLLLLLLLLLLLLLLLLLLLLLLLLLLLLLLLLLLLLLLLLLLLLLLLLLLLLLLLLLLLLLLLLLLLLLLLLLLLLLLCSS....................................
LLLLLLLLLLLLLLLLLLLLLLLLLLLLLLLLLLLLLLLLLLLLLLLLLLLLLLLLLLLLLLLLLLLLLLLLLLLLLLLLLLLLLLLLLLCSSS..................................
LLLLLLLLLLLLLLLLLLLLLLLLLLLLLLLLLLLLLLLLLLLLLLLLLLLLLLLLLLLLLLLLLLLLLLLLLLLLLLLLLLLLLLLLLLLCSSS.................................
LLLLLLLLLLLLLLLLLLLLLLLLLLLLLLLLLLLLLLLLLLLLLLLLLLLLLLLLLLLLLLLLLLLLLLLLLLLLLLLLLLLLLLLLLLLLLCSS................................
LLLLLLLLLLLLLLLLLLLLLLLLLLLLLLLLLLLLLLLLLLLLLLLLLLLLLLLLLLLLLLLLLLLLLLLLLLLLLLLLLLLLLLLLLLLLLCSS................................
LLLLLLLLLLLLLLLLLLLLLLLLLLLLLLLLLLLLLLLLLLLLLLLLLLLLLLLLLLLLLLLLLLLLLLLLLLLLLLLLLLLLLLLLLLLLLLCSS...............................
LLLLLLLLLLLLLLLLLLLLLLLLLLLLLLLLLLLLLLLLLLLLLLLLLLLLLLLLLLLLLLLLLLLLLLLLLLLLLLLLLLLLLLLLLLLLLLLCSS..............................
LLLLLLLLLLLLLLLLLLLLLLLLLLLLLLLLLLLLLLLLLLLLLLLLLLLLLLLLLLLLLLLLLLLLLLLLLLLLLLLLLLLLLLLLLLLLLLLLCS..............................
LLLLLLLLLLLLLLLLLLLLLLLLLLLLLLLLLLLLLLLLLLLLLLLLLLLLLLLLLLLLLLLLLLLLLLLLLLLLLLLLLLLLLLLLLLLLLLLLCCS.............................
LLLLLLLLLLLLLLLLLLLLLLLLLLLLLLLLLLLLLLLLLLLLLLLLLLLLLLLLLLLLLLLLLLLLLLLLLLLLLLLLLLLLLLLLLLLLLLLLLCCS............................
LLLLLLLLLLLLLLLLLLLLLLLLLLLLLLLLLLLLLLLLLLLLLLLLLLLLLLLLLLLLLLLLLLLLLLLLLLLLLLLLLLLLLLLLLLLLLLLLLLCCS...........................
LLLLLLLLLLLLLLLLLLLLLLLLLLLLLLLLLLLLLLLLLLLLLLLLLLLLLLLLLLLLLLLLLLLLLLLLLLLLLLLLLLLLLLLLLLLLLLLLLLCCC...........................
LLLLLLLLLLLLLLLLLLLLLLLLLLLLLLLLLLLLLLLLLLLLLLLLLLLLLLLLLLLLLLLLLLLLLLLLLLLLLLLLLLLLLLLLLLLLLLLLLLCCC...........................
