..........................################################################################################......................
..........................#################################################################################.....................
..........................###################################################################################...................
..........................####################################################################################..................
..........................#####################################################################################.................
...........................####################################################################################.................
............................####...############################################################################.................
...................................############################################################################.................
......................................########################################################################..................
.......................................######################################################################...................
........................................##################################################################......................
..........................................################################################################......................
...........................................###############################################################......................
.............................................############################################################.......................
..............................................#########################################################.........................
.................................................#####################################################..........................
.....................................................#################################################..........................
.........................................................#############################################..........................
..........................................................############################################..........................
..............................................................#######################################...........................
...............................................................#####################################............................
................................................................####################################............................
.................................................................####################################...........................
.................................................................####################################...........................
.................................................................####################################...........................
..................................................................###################################...........................
...................................................................###################################..........................
...................................................................###################################..........................
....................................................................##################################..........................
.......................................................................###############################..........................
........................................................................#############################...........................
.......................................................................#############################............................
........................................................................###########################.............................
.........................................................................########################...............................
..........................................................................################......................................
...........................................................................##############.......................................
............................................................................############........................................
.............................................................................########...........................................
...............................................................................##...............................................
................................................................................................................................
................................................................................................................................
................................................................................................................................
................................................................................................................................
................................................................................................................................
....................................................oooo..ooo.o..o.o...o.oooo.oooo..............................................
....................................................o....o....o..o.oo..o.o....o.................................................
....................................................oooo.o....oooo.o.o.o.oooo.oooo..............................................
.......................................................o.o....o..o.o..oo.o....o.................................................
....................................................oooo..ooo.o..o.o...o.oooo.oooo..............................................
................................................................................................................................
................................................................................................................................
................................................................................................................................
................................................................................................................................
................................................................................................................................
................................................................................................................................
........................................................................##......................................................
......................................................................####......................................................
.....................................................................#####......................................................
..............................................................###...######......................................................
..........................................................################......................................................
.........................................................##################.....................................................
........................................................#######################.................................................
......................................................##########################................................................
.....................................................############################...............................................
.....................................................############################...............................................
....................................................#############################...............................................
.................................................#################################..............................................
................................................##################################..............................................
...............................................####################################.............................................
...............................................#####################################............................................
...............................................######################################...........................................
...............................................######################################...........................................
..............................................#######################################...........................................
.............................................#########################################..........................................
..........................................############################################..........................................
...................................###################################################..........................................
..................................####################################################..........................................
.................................#####################################################..........................................
...............................#######################################################..........................................
...............................#######################################################..........................................
..............................#########################################################.........................................
.............................##########################################################.........................................
............................###########################################################.........................................
...........................#############################################################........................................
.........................###############################################################........................................
.........................################################################################.......................................
........................#################################################################.......................................
........................#################################################################.......................................
.......................##################################################################.......................................
.......................##################################################################.......................................
.......................##################################################################.......................................
.......................##################################################################.......................................
.......................##################################################################.......................................
........................#################################################################.......................................
.##.....................#################################################################.......................................
#####..####............#################################################################........................................
############..........##################################################################........................................
############..........#################################################################.........................................
#############........##################################################################.........................................
###############....####################################################################.........................................
######################################################################################..........................................
######################################################################################..........................................
#####################################################################################...........................................
######################################################################################..........................................
######################################################################################..........................................
######################################################################################..........................................
#####################################################################################...........................................
######################################################################################..........................................
######################################################################################..........................................
#######################################################################################.........................................
#######################################################################################.........................................
########################################################################################........................................
#########################################################################################.......................................
##########################################################################################......................................
##########################################################################################......................................
###########################################################################################.....................................
############################################################################################....................................
#############################################################################################...................................
##############################################################################################..................................
###############################################################################################.................................
################################################################################################................................
#################################################################################################...............................
#################################################################################################...............................
##################################################################################################..............................
###################################################################################################.............................
####################################################################################################............................
####################################################################################################............................
####################################################################################################............................
