SS..SSSSSSSSSS........S........................................................................................................S
S..SSSSSSSSSSSSS......S.........................................................................................................
..SSSSSCCCCCCSSSS..SS.SS........................................................................................................
.SSSSCCCCCCCCCCSSS.S..SS........................................................................................................
.SSSSCCCCCCCCCCCSSS.............................................................................................................
SSSSCCCCCLLLCCCCSSSSS...........................................................................................................
SSSCCCCLLLLLLCCCCCSSSS..........................................................................................................
SSSCSCCLLLLLLLCCCCCCSSS.........................................................................................................
SSSSSCCCLLLLLLLCCCCCCSS.........................................................................................................
.SSSCSCCCLLLLLLLLLCCCSS.........................................................................................................
.SSSSSCCCCCLLLLLLCCCSSS.........................................................................................................
..SSSSCCCCCLLLLLLCCCSS.......................SSSSSSSS...........................................................................
...SSSSSSCCCCCCCCCCSSS......................SSSSSSSSSSS.........................................................................
....SSSSSSCCCCCCCCSSS......................SSSCSSCCCSSSS.SSSSS..................................................................
......SSSSSSSCCCCSSSS......................SSCCCCCCCCCSSSSSSSSSSSS.........SSSSSSSS.............................................
.......SSSSSSSSSSSSS.....................SSSCCCCCCCCCCCSSCCCCCSSSSSS..SSS.SSSSSSSSSS............................................
............SSSSSSS.....................SSSSCCCLLLLLLCCCCCCCCCCCCSSSS.SSSSSSCCCCCCSSS...........................................
....................................SSSSSSSCCCLLLLLLLCCCCCLLLCCCCCSSSSSSSSCCCCCCCCCSSS..........................................
..................................SSSSSSSCSCCLLLLLLLLLLLCLLLLLLLCCCCSSSSSCCCCLLLCCCCCSS.........................................
..................................SSSCCSCCCCCLLLLLLLLLLLLLLLLLLLLCCCCCCCCCCLLLLLLLCCCSS.........................................
.................................SSSCCCCCCCCLLLLLLLLLLLLLLLLLLLLLLLCCCCCCCLLLLLLLLLCCSSS........................................
................................SSSCCCCCCLLLLLLLLLLLLLLLLLLLLLLLLLLLLLLLLLLLLLLLLLLLCCSS........................................
..............................SSSSCCCLLLLLLLLLLLLLLLLLLLLLLLLLLLLLLLLLLLLLLLLLLLLLLCCSSS........................................
.............................SSSSCCCCLLLLLLLLLLLLLLLLLLLLLLLLLLLLLLLLLLLLLLLLLLLLLCCCSSS........................................
............................SSSCCCCCLLLLLLLLLLLLLLLLLLLLLLLLLLLLLLLLLLLLLLLLLLLLLCCCCSS.........................................
...........................SSSCCCCCCLLLLLLLLLLLLLLLLLLLLLLLLLLLLLLLLLLLLLLLLLLLLLCCCSSS.........................................
...........................SSCCCCLLLLLLLLLLLLLLLLLLLLLLLLLLLLLLLLLLLLLLLLLLLLLLLCCCCSS..........................................
...........................SSCCCLLLLLLLLLLLLLLLLLLLLLLLLLLLLLLLLLLLLLLLLLLLLLLLLCCSSS...........................................
...........................SSCCCLLLLLLLLLLLLLLLLLLLLLLLLLLLLLLLLLLLLLLLLLLLLLLLCCCSS..S.........................................
...........................SSCCCLLLLLLLLLLLLLLLLLLLLLLLLLLLLLLLLLLLLLLLLLLLLLLCCCCSS..S.........................................
...........................SSCCCLLLLLLLLLLLLLLLLLLLLLLLLLLLLLLLLLLLLLLLLLLLLLCCCCSSSS.S.........................................
...........................SSSCCCLLLLLLLLLLLLLLLLLLLLLLLLLLLLLLLLLLLLLLLLLLLCCCCSSS.SSS.........................................
...........................SSSCCCLLLLLLLLLLLLLLLLLLLLLLLLLLLLLLLLLLLLLLLLLLLCCCSSS..SS..........................................
............................SSCCCLLLLLLLLLLLLLLLLLLLLLLLLLLLLLLLLLLLLLLLLLLLCCCSS................................SSS............
...........................SSSCCCLLLLLLLLLLLLLLLLLLLLLLLLLLLLLLLLLLLLLLLLLLCCCSSS.............................SSSSSSSS..........
............................SSCCCLLLLLLLLLLLLLLLLLLLLLLLLLLLLLLLLLLLLLLLLLCCCCSS.............................SSSSSSSSSS.........
............................SSSCCCCLLLLLLLLLLLLLLLLLLLLLLLLLLLLLLLLLLLLLLLCCCSSS.........................SSSSSSCCCCCCSSS........
.............................SSSCCCCLLLLLLLLLLLLLLLLLLLLLLLLLLLLLLLLLLCLCCCCCSS.........................SSSSSCCCCLCCCCSSS.......
..............................SSSCCCCLLLLLLLLLLLLLLLLLLLLLLLLLLLLLLLCCCCCCCCSSS.........................SSSCCCCCLLLCCCCSS.......
...............................SSSCCCCCLLLLLLLLLLLLLLLLLLLLLLCCCLLLCCCCCCCSSSS........................SSSSCCCCCCLLLLLCCCSS......
................................SSSCCCCCLLLLLLLLLLLLLLLLLLLLCCCCCCCCCSSSSSSSSS........................SSSSCCLCLLLLLLLCCCSS......
.................................SSSCCCCCLLLLLLLLLLLLLLLLLLLCCCCCCSSSSSSSSS...........................SSSCCCCLLLLLLLLLCCCSS.....
..................................SSSSCCCLLLLLLLLLLLLLLLLLCCCSSSSSSSS.................................SSSCCLLLLLLLLLLLLCCSS.....
...................................SSSSCCCCCLCCCCCCCLLLLLLCCCSSSSSS..................................SSSCCLLLLLLLLLLLLLCCSS.....
.....................................SSSCCCCCCCCCCCCCCLLCCCCSSS.....................................SSSCCCLLLLLLLLLLLLCCCSS.....
......................................SSSSSSSSSSSSSSCCCCSSSSSS.....................................SSSCCCCLLLLLLLLLLLLCCCSS.....
.......................................SSSSSSSSSSSSSSSSSSSSSS......................................SSCCCLLLLLLLLLLLLLLLCCSS.....
................................................SS.SSSS...........................................SSSCCLLLLLLLLLLLLLLLLCCSS.....
..................................................................................................SSCCCLLLLLLLLLLLLLLLCCCSS.....
..................................................................................................SSCCLLLLLLLLLLLLLLLLCCSSS.....
..................................................................................................SSCCCLLLLLLLLLLLLLLCCCSSS.....
.................................................................................................SSSCCCCCLLLLLLLLLLLCCCSS.S.....
.................................................................................................SSSCCCCCCCLLLLLLLLLCCSSS.S.....
..................................................................................................SSSSCCCCCLLLLLLLLLCCCSS.S.....
...................................................................................................SSSSSSCCCCCLLLLLLCCCSS.S.....
.....................................................................................................SSSSSSCCCLLLLLLCCCSS.......
.........................................................................................................SSCCCCLLLLLCCCSS.......
.........................................................................................................SSSCCCCCLCCCCSSS.......
.........................................................................................................SSSSCCCCCCCCSSS........
..........................................................................................................SSSSSCCCCSSSS.........
...........................................................................................................SSSSSSSSSSS..........
.............................................................................................................SSSSSS.............
...............................................................SS...............................................................
..............................................................SSSS..............................................................
..............................................................SSSS..............................................................
...............................................................SS...............................................................
............................................................................SSSSS...............................................
..........................................................................SSSSSSSSS.............................................
............SSSSSSS.....................................................SSSSSSCSSSSSS...........................................
..........SSSSSSSSSSSSSSSS..............................................SSSSSCCCCCSSS...........................................
.........SSSSSCCCSSSSSSSSS..............................................SSSCCCCCCCCSSS..........................................
........SSSSSCCCCCCCCCCCSSS............................................SSSCCCCLLCCCCSS..........................................
........SSSSCCCCCCCCCCCCCSS............................................SSSCCCLLLLCCCSS..........................................
.......SSSSCCCLLLLLLLLCCCSS...........................................SSSCCCLLLLLLCCSS..........................................
......SSSSCCLLLLLLLLLCCCCSS...........................................SSSCCLLLLLLCCSSS..........................................
......SSSCCCLLLLLLLLLCCCSS............................................SSSCCLLLLLCCCSSS..........................................
......SSSCCCLLLLLLLCCCCCSS............................................SSSCCCCLLCCCSSS...........................................
......SSSCCCCLLLLCCCCCCSSS.............................................SSSCCCCCCCSSS............................................
.......SSSSCCCCCCCCCSSSSSS..............................................SSSCCCCCCSSS............................................
........SSSSSCCCCCCSSSSSSS..............................................SSSSSCCCSSSS............................................
...........SSSSCCCSSSSSSSS...............................................SSSSSSSSS..............................................
............SSSSSSSSSSSSSS.................................SSS.............SSSSSS...............................................
..............SSSSSS....................................SSSSSSSS................................................................
......................................................SSSSSSSSSSSS..............................................................
.....................................................SSSSCCCCCSSSS..............................................................
....................................................SSSSCCCCCCCCSSS.............................................................
...................................................SSSSCCCCLLLCCCSSS............................................................
..................................................SSSSCCCLLLLLLCCCSS............................................................
..................................................SSSSCCLLLLLLLLCCSS............................................................
..................................................SSSCCCLLLLLLLLCCSS............................................................
.................SS...............................SSSCCCLLLLLLLCCCSS..................SSSSSSSSS.................................
...............SSSSSSS............................SSSCCCLLLLLLLCCCSS...............SSSSSSSSSSSSSS...............................
.............SSSSCCCSSSS.........................SSSSCCLLLLLLLLCCSSS.............SSSSSSSSSSSSSSSSSSS..SS........................
.............SSSCCCCCCSSSS.......................SSSCCCLLLLLLLLCCSSS...........SSSSSSSSSCCCCCCCCSSSSS.SS........................
...........SSSSCCCLLCCCCSSSSS...................SSSCCLLLLLLLLLLLCCSS..........SSSSSSSCCCCCCCCCCCCCSSSS..........................
..........SSSSSCCLLLLLLCCCSSS...................SSCCCLLLLLLLLLLCCCSS..........SSSSCCCCCLLLLLLCCCCCCSSSS.........................
..........SSSSCCCLLLLLLLCCCSSS..................SSCCCLLLLLLLLLLCCCSS.........SSSCCCCLLLLLLLLLLLLCCCCSSS.........................
.........SSSSCCCLLLLLLLLLCCCSSS.................SSSCCLLLLLLLLLLCCCSS........SSSCCCCCLLLLLLLLLLLLLLCCCSSS........................
.........SSSCCLLLLLLLLLLLLCCSSS.................SSCCCLLLLLLLLLLLCSSS........SSSCCLLLLLLLLLLLLLLLLLLCCSSS........................
.........SSSCCCLLLLLLLLLLLLCCSSS................SSCCLLLLLLLLLLLCCSS.........SSSCCLLLLLLLLLLLLLLLLLCCCSSSS.......................
..........SSCCCCLLLLLLLLLLLCCCSS................SSCCCLLLLLLLLLCCCSS.........SSCCCLLLLLLLLLLLLLLLLLLCCCSSS.......................
..........SSSCCCLLLLLLLLLLLCCCS.................SSCCCLLLLLLLLLCCCSS.........SSCCCLLLLLLLLLLLLLLLLLLCCCCSS.......................
...........SSSSCCLLLLLLLLCCCCSS..................SSCCCLLLLLLCCCCSSS.........SSCCLLLLLLLLLLLLLLLLLLLLCCCSS.......................
............SSSCCCLLLLLLCCCCCSS..................SSSCCCCCCCCCCCSSS..........SSCCLLLLLLLLLLLLLLLLLLLLLLCSSS......................
............SSSSCCLLLLLLCCSSSSS..................SSSSCCCCCCCCSSSS...........SSCCLLLLLLLLLLLLLLLLLLLLLCCSSS......................
............SSSSCCLLLLLCCCSSSS...................SSSSSSSSSSSSSSS.SS........SSSCCLLLLCCLLLLLLLLLLLLLLLCCCSS......................
............SSSSCCLLLLLCCCSSSS...................SSSSSSSSSSSS...SS.........SSCCCLLLLCCCCCCCCLLCCCLLLLCCCSS......................
.............SSSCCCLLLLCCSS...............................................SSSCCLLLLCCCCCSCCCCCLCCCCLLCCCSS......................
.............SSSCCCLLCCCCSS...............................................SSSCLLLLCCSSSSSSSSCCCCCCCCCCCCSS......................
..............SSSCCCCCCCSS...............................................SSSCCCLLCCSSSSSSSSSSSSCCCCLCCCSSS......................
..............SSSCCCCCCSS................................................SSSCCCLCCCSSSS.SSSSSSSSSCCCCCCSS.......................
................SSSSCSSSS.................................................SSCCCCCCSSS........SSSSSSSCSSSS.......................
.................SSSSSSS..................................................SSSCCCCSSS............SSSSSSS.........................
...........................................................................SSSSSSSS................S............................
............................................................................SSSSSSS.............................................
...........................................................................SSSSSS...............................................
................................................................................................................................
................................................................................................................................
................................................................................................................................
................................................................................................................................
................................................................................................................................
................................................................................................................................
................................................................................................................................
................................................................................................................................
................................................................................................................................
................................................................................................................................
................................................................................................................................
S..............................................................................................................................S
