SS............................................SSSSSSS...............................SSSSSSSLLLLLLLLLLLLLLLLLLLLLLLLLLLLLLLLLLLLL
S...........................................SSSSSSSSSSSSS...........................SSSSSSLLLLLLLLLLLLLLLLLLLLLLLLLLLLLLLLLLLLLL
.................SSSS......................SSSSSSSSSSSSSSS.........................SSSSSSLLLLLLLLLLLLLLLLLLLLLLLLLLLLLLLLLLLLLLL
...............SSSSSSSSS.SSS..............SSSSSSSSSSSSSSSSS.......................SSSSSSSLLLLLLLLLLLLLLLLLLLLLLLLLLLLLLLLLLLLLLL
...............SSSSSSSSSSSSSS............SSSSSSSSSSSSSSSSSS......................SSSSSSLSLLLLLLLLLLLLLLLLLLLLLLLLLLLLLLLLLLLLLLL
..............SSSSSSSSSSSSSSS............SSSSSSSSSSSSSSSSSSS.....................SSSSSSLSLLLLLLLLLLLLLLLLLLLLLLLLLLLLLLLLLLLLLLL
............SSSSSSSSSSSSSSSSSS..........SSSSSSSSLLLLSSSSSSSS.....................SSSSSSLSSLLLLLLLLLLLLLLLLLLLLLLLLLLLLLLLLLLLLLL
............SSSSSSSSSSSSSSSSSS.........SSSSSSSLLLLLLLSSSSSSS.....................SSSSSSSSLLLLLLLLLLLLLLLLLLLLLLLLLLLLLLLLLLLLLLL
............SSSSSSSSSSSSSSSSSSS........SSSSSSLLLLLLLLSSSSSSS.....................SSSSSSSLLLLLLLLLLLLLLLLLLLLLLLLLLLLLLLLLLLLLLLL
............SSSSSSSSLLLLSSSSSSS.......SSSSSSSSLLLLLLLLLSSSSS.....................SSSSSSSLLLLLLLLLLLLLLLLLLLLLLLLLLLLLLLLLLLLLLLL
.........S.SSSSSSSSLLLLLLLSSSSS.......SSSSSSSLLLLLLLLSSSSSS.......................SSSSSSLLLLLLLLLLLLLLLLLLLLLLLLLLLLLLLLLLLLLLLL
.........S.SSSSSSSLLLLLLLLSSSSS.......SSSSSSLLLLLLLLSSSSSSS.......................SSSSSSLLLLLLLLLLLLLLLLLLLLLLLLLLLLLLLLLLLLLLLL
..........SSSSSSSLLLLLLLLLSSSSS.......SSSSSSLLLLLLLLSSSSSSS.......................SSSSSSLLLLLLLLLLLLLLLLLLLLLLLLLLLLLLLLLLLLLLLL
..........SSSSSSSLLLLLLLLLSSSSSS......SSSSSSLLLLLLLLSSSSSS.......................SSSSSSSSLLLLLLLLLLLLLLLLLLLLLLLLLLLLLLLLLLLLLLL
.........SSSSSSSSLLLLLLLLLSSSSSS......SSSSSSLLLLLLLSSSSSSS........................SSSSSSSSLLLLLLLLLLLLLLLLLLLLLLLLLLLLLLLLLLLLLL
.........SSSSSSSSLLLLLLLLLSSSSSS.......SSSSSSSLLLLLSSSSSSS........................SSSSSSSSSLLLLLLLLLLLLLLLLLLLLLLLLLLLLLLLLLLLLL
.........SSSSSSSLLLLLLLLLLSSSSSS.......SSSSSSSSLSSLSSSSSSS........................SSSSSSSSSSLLLLLLLLLLLLLLLLLLLLLLLLLLLLLLLLLLLL
.........SSSSSLLLLLLLLLLLLLSSSSS.......SSSSSSSSSSSSSSSSSS..........................SSSSSSSSLLLLLLLLLLLLLLLLLLLLLLLLLLLLLLLLLLLLL
........SSSSSLLLLLLLLLLLLLLSSSSS.......SSSSSSSSSSSSSSSSSS..........................S.SSSSSSLLLLLLLLLLLLLLLLLLLLLLLLLLLLLLLLLLLLL
........SSSSSLLLLLLLLLLLLLLSSSSS......SSSSSSSSSSSSSSSSSS..............................SSSSSLSLLLLLLLLLLLLLLLLLLLLLLLLLLLLLLLLLLL
........SSSSSLLLLLLLLLLLLLLSSSSS.....SSSSSSSSSSSSSSSSSS..............................SSSSSSLSLLLLLLLLLLLLLLLLLLLLLLLLLLLLLLLLLLL
........SSSSSSLLLLLLLLLLLLLSSSSS....SSSSSSSSSSSSSSSSSS...............................SSSSSLLLLLLLLLLLLLLLLLLLLLLLLLLLLLLLLLLLLLL
........SSSSSSSLLLLLLLLLLLLSSSSS....SSSSSSSSSSSSSSSS................................SSSSSSLLLLLLLLLLLLLLLLLLLLLLLLLLLLLLLLLLLLLL
.........SSSSSSSLLLLLLLLLLLSSSSS...SSSSSSLSSSSSSSSS.SSS.............................SSSSSSLLLLLLLLLLLLLLLLLLLLLLLLLLLLLLLLLLLLLL
.........SSSSSSSSLLLLLLLLSLSSSSS...SSSSSSLLSSSSSSSS.SSS.............................SSSSSSLLLLLLLLLLLLLLLLLLLLLLLLLLLLLLLLLLLLLL
.........SSSSSSSSLLLLLLLLSLSSSSS...SSSSSSSSSSSSSSSS.S..SS...........................SSSSSSSLLLLLLLLLLLLLLLLLLLLLLLLLLLLLLLLLLLLL
..........SSSSSSSLLLLLLLLSSSSSSS...SSSSSSSLSSSSSSSSS...S............................SSSSSSSLLLLLLLLLLLLLLLLLLLLLLLLLLLLLLLLLLLLL
..........SSSSSSLLLLLLLLLSSSSSSSS..SSSSSSSLSSSSSSSSS...S............................SSSSSSSSLLLLLLLLLLLLLLLLLLLLLLLLLLLLLLLLLLLL
..........SSSSSSSLLLLLLLLLSSSSSSS...SSSSSSSLSSSSSSSS..............................SSSSSSSSSSLLLLLLLLLLLLLLLLLLLLLLLLLLLLLLLLLLLL
...........SSSSSSSLLLLLLLLSSSSSSSS..SSSSSSSSLLSSSSSS..............................SSSSSSSSSLLLLLLLLLLLLLLLLLLLLLLLLLLLLLLLLLLLLL
...........SSSSSSSSLLLLLLLSSSSSSSS...SSSSSSSSLSSSSSS...............................SSSSSSSLLLLLLLLLLLLLLLLLLLLLLLLLLLLLLLLLLLLLL
...........SSSSSSSSLLLLLLLLSSSSSSSS..SSSSSSSSSSSSSSS.............................SSSSSSSSSSLLLLLLLLLLLLLLLLLLLLLLLLLLLLLLLLLLLLL
...........SSSSSSSLSLLLLLLLSSSSSSSS..SSSSSSSSSSSSSS............................SSSSSSSSSSSSLLLLLLLLLLLLLLLLLLLLLLLLLLLLLLLLLLLLL
...........SSSSSSSSSLLLLLLLLSSSSSSSS...SSSSSSSSSSSS...........................SSSSSSSSSSSSLLLLLLLLLLLLLLLLLLLLLLLLLLLLLLLLLLLLLL
...........SSSSSSSLLLLLLLLLLLSSSSSSS....SSSSSSSSSSS...........................SSSSSSSLLLLLLLLLLLLLLLLLLLLLLLLLLLLLLLLLLLLLLLLLLL
...........SSSSSSSLLLLLLLLLLLSSSSSSS....SSSSSSSSSS............................SSSSSSLLLLLLLLLLLLLLLLLLLLLLLLLLLLLLLLLLLLLLLLLLLL
............SSSSSSLLLLLLLLLLSSSSSSS......SSSSSSSS...........................SSSSSSSSLLLLLLLLLLLLLLLLLLLLLLLLLLLLLLLLLLLLLLLLLLLL
............SSSSSSSLLLLLLLLSSSSSSSS.......SSSSSSS............................SSSSSSSLLLLLLLLLLLLLLLLLLLLLLLLLLLLLLLLLLLLLLLLLLLL
............SSSSSSSLLLLLLLLLSSSSSSS..............S..........................SSSSSSSLLLLLLLLLLLLLLLLLLLLLLLLLLLLLLLLLLLLLLLLLLLLL
............SSSSSSLLLLLLLLLSSSSSSS..........................................SSSSSSSLLLLLLLLLLLLLLLLLLLLLLLLLLLLLLLLLLLLLLLLLLLLL
............SSSSSSSLLLLLLSSLSSSSS...........................................SSSSSSSLLLLLLLLLLLLLLLLLLLLLLLLLLLLLLLLLLLLLLLLLLLLL
............SSSSSSSSSSSSSSSSSSSSS..........................................SSSSSSSLLLLLLLLLLLLLLLLLLLLLLLLLLLLLLLLLLLLLLLLLLLLLL
.............SSSSSSSSSSSSSSSSSSSSS.........................................SSSSSSSLLLLLLLLLLLLLLLLLLLLLLLLLLLLLLLLLLLLLLLLLLLLLL
..............SSSSSSSSSSSSSSSSS.SS........................................SSSSSSSSLLLLLLLLLLLLLLLLLLLLLLLLLLLLLLLLLLLLLLLLLLLLLL
..............SSSSSSSSSSSSSSSS...........................................SSSSSSSLLLLLLLLLLLLLLLLLLLLLLLLLLLLLLLLLLLLLLLLLLLLLLLL
..............SSSSSSSSSSSSSSS............................................SSSSSSSLLLLLLLLLLLLLLLLLLLLLLLLLLLLLLLLLLLLLLLLLLLLLLLL
.............SSS.SSSSSSSSS...............................................SSSSSSSLLLLLLLLLLLLLLLLLLLLLLLLLLLLLLLLLLLLLLLLLLLLLLLL
...................SSSS..................................................SSSSSSSLLLLLLLLLLLLLLLLLLLLLLLLLLLLLLLLLLLLLLLLLLLLLLLL
........................................................................SSSSSSSSLLLLLLLLLLLLLLLLLLLLLLLLLLLLLLLLLLLLLLLLLLLLLLLL
........................................................................SSSSSSSLLLLLLLLLLLLLLLLLLLLLLLLLLLLLLLLLLLLLLLLLLLLLLLLL
.........................................................................SSSSSSSLLLLLLLLLLLLLLLLLLLLLLLLLLLLLLLLLLLLLLLLLLLLLLLL
.........................................................................SSSSSSLLLLLLLLLLLLLLLLLLLLLLLLLLLLLLLLLLLLLLLLLLLLLLLLL
.........................................................................SSSSSSSLLLLLLLLLLLLLLLLLLLLLLLLLLLLLLLLLLLLLLLLLLLLLLLL
.........................................................................SSSSSSSLLLLLLLLLLLLLLLLLLLLLLLLLLLLLLLLLLLLLLLLLLLLLLLL
.........................................................................SSSSSSSLLLLLLLLLLLLLLLLLLLLLLLLLLLLLLLLLLLLLLLLLLLLLLLL
..........................................................................SSSSSSLLLLLLLLLLLLLLLLLLLLLLLLLLLLLLLLLLLLLLLLLLLLLLLL
..........................................................................SSSSSSLLLLLLLLLLLLLLLLLLLLLLLLLLLLLLLLLLLLLLLLLLLLLLLL
..........................................................................SSSSSSLLLLLLLLLLLLLLLLLLLLLLLLLLLLLLLLLLLLLLLLLLLLLLLL
..........................................................................SSSSSSSSLLLLLLLLLLLLLLLLLLLLLLLLLLLLLLLLLLLLLLLLLLLLLL
..........................................................................SSSSSSSLSLLLLLLLLLLLLLLLLLLLLLLLLLLLLLLLLLLLLLLLLLLLLL
..........................................................................SSSSSSSLSLLLLLLLLLLLLLLLLLLLLLLLLLLLLLLLLLLLLLLLLLLLLL
...........................................................................SSSSSSSLLLLLLLLLLLLLLLLLLLLLLLLLLLLLLLLLLLLLLLLLLLLLL
......................SSSSSSSSS................................S...........SSSSSSSSLLLLLLLLLLLLLLLLLLLLLLLLLLLLLLLLLLLLLLLLLLLLL
....................SSSSSSSSSSSS..............................SS.S.........SSSSSSSSLLLLLLLLLLLLLLLLLLLLLLLLLLLLLLLLLLLLLLLLLLLLL
.SS............SS.SSSSSSSSSSSSSSS.SSS.........................SSSS..........SSSSSSSLLLLLLLLLLLLLLLLLLLLLLLLLLLLLLLLLLLLLLLLLLLLL
.SS...........SSS.SSSSSSSSSSSSSSS..............................SS...........SSSSSSSSSLLLLLLLLLLLLLLLLLLLLLLLLLLLLLLLLLLLLLLLLLLL
.SS...SSS........SSSSSSSSSSSSSSSSS...........................................SSSSSSSSSSLLLLLLLLLLLLLLLLLLLLLLLLLLLLLLLLLLLLLLLLL
.....SSSS......SSSSSSSSSSSSSSSSSSS............................................SSSSSSSSSSSLLLLLLLLLLLLLLLLLLLLLLLLLLLLLLLLLLLLLLL
S....SS........SSSSSSSSSLSLSSSSSSS............................................SSSSSSSSSSSLLLLLLLLLLLLLLLLLLLLLLLLLLLLLLLLLLLLLLL
S...............SSSSSSSLLLLSSSSSSS............................................SSSSSSSSSSSLLLLLLLLLLLLLLLLLLLLLLLLLLLLLLLLLLLLLLL
S..............SSSSSSSLLLLLLSSSSSSS.......................................S....SSSSSSSSSSSSSSLLLLLLLLLLLLLLLLLLLLLLLLLLLLLLLLLLL
S.............SSSSSSSLLLLLLLLSSSSSS.......................................S.....SSSSSSSSSSSSSLLLLLLLLLLLLLLLLLLLLLLLLLLLLLLLLLLL
S.....SS...S.SSSSSSSLLLLLLLLLSSSSSS..............................................SSSSSSSSSLLSLLLLLLLLLLLLLLLLLLLLLLLLLLLLLLLLLLL
S.S...SS..SSSSSSSSSSLLLLLLLLSSSSSSSS.............................................SSSSSSSSSSSLLLLLLLLLLLLLLLLLLLLLLLLLLLLLLLLLLLL
SSS....S.S..SSSSSSSSLLLLLLLLSSSSSSSS.............................................SSSSSSSSSSSLLLLLLLLLLLLLLLLLLLLLLLLLLLLLLLLLLLL
S.....S.....SSSSSSSLLLLLLLLLSSSSSSSS.............................................S.SSSSSSSLLLLLLLLLLLLLLLLLLLLLLLLLLLLLLLLLLLLLL
S.S...S....SSSSSSSLLLLLLLLLSSSSSSS................................................SSSSSSSSLSLLLLLLLLLLLLLLLLLLLLLLLLLLLLLLLLLLLL
S.SS.......SSSSSSLLLLLLLLLSSSSSSSSS.................................................SSSSSSLSLLLLLLLLLLLLLLLLLLLLLLLLLLLLLLLLLLLL
S..S......SSSSSSSLLLLLLLLLSSSSSSS.S.................................................SSSSSSSSLLLLLLLLLLLLLLLLLLLLLLLLLLLLLLLLLLLL
S........SSSSSSSSSLLLLLLLLSSSSSSSSS.................................................SSSSSLLLLLLLLLLLLLLLLLLLLLLLLLLLLLLLLLLLLLLL
S........SSSSSSSLSLLLLLLLLSSSSSS....................................................SSSSSSSLLLLLLLLLLLLLLLLLLLLLLLLLLLLLLLLLLLLL
........SSSSSSSSLLLLLLLLSSSSSSSS....................................................SSSSSSSSLLLLLLLLLLLLLLLLLLLLLLLLLLLLLLLLLLLL
.....S.SSSSSSSSLLLLLLLLSSSSSSSS.....................................................SSSSSSSSLLLLLLLLLLLLLLLLLLLLLLLLLLLLLLLLLLLL
.....SSSSSSSSSLLLLLLLLSSSSSSSSS..SS...........................................S.....SSSSSSSSLLLLLLLLLLLLLLLLLLLLLLLLLLLLLLLLLLLL
....SSSSSSSSLLLLLLLLLLSSSSSSSS................................................S.....SSSSSSSSLLLLLLLLLLLLLLLLLLLLLLLLLLLLLLLLLLLL
.....SSSSSSSLLLLLLLLLLSSSSSSS.....................................................SSSSSSSSSSLLLLLLLLLLLLLLLLLLLLLLLLLLLLLLLLLLLL
.S...SSSSSSLLLLLLLLLLSSSSSSS...................................................SSSSSSSSSSSSSLLLLLLLLLLLLLLLLLLLLLLLLLLLLLLLLLLLL
.S...SSSSSSLLLLLLLLLLSSSSSS....................................................SSSSSSSSSSSSLLLLLLLLLLLLLLLLLLLLLLLLLLLLLLLLLLLLL
.S....SSSSSSLLLLLLLLSSSSSSS.....SS............................................SSSSSSSSSSSSLLLLLLLLLLLLLLLLLLLLLLLLLLLLLLLLLLLLLL
.S....SSSSSSSLLLLLLLSSSSSSSS......SSSSSS......................................SSSSSSSSSLLLLLLLLLLLLLLLLLLLLLLLLLLLLLLLLLLLLLLLLL
SS...SSSSSSSSSLLLLLSSSSSS.S.....SSSSSSSSSSSSSSSSSSS..........................SSSSSSSSSLLLLLLLLLLLLLLLLLLLLLLLLLLLLLLLLLLLLLLLLLL
SS....SSSSSSSSLLLLSSSSSSS..SSSSSSSSSSSSSSSSSSSSSSSSSSS.......................SSSSSSLLSLLLLLLLLLLLLLLLLLLLLLLLLLLLLLLLLLLLLLLLLLL
SS....SSSSSSSLLLLSSSSSSS..SSSSSSSSSSSSSSSSSSSSSSSSSSSSSSS.S..................SSSSSLSSLLLLLLLLLLLLLLLLLLLLLLLLLLLLLLLLLLLLLLLLLLL
SS....SSSSSSSLLLLSSSSSS.SSSSSSSSSSSSSSSSSSSSSSSSSSSSSSSSSSSSSSS.............SSSSSSSSSLLLLLLLLLLLLLLLLLLLLLLLLLLLLLLLLLLLLLLLLLLL
SS....SSSSSSSSLSSSSSSSSSSSSSSSSSSSSSSSSSSSSSSSSSSSSSSSSSSSSSSSSS............SSSSSSSSSLLLLLLLLLLLLLLLLLLLLLLLLLLLLLLLLLLLLLLLLLLL
S.......SSSSSSSSSSSSSSSSSSSSSSSSSSSSSSSSSSSSSSSSSSSSSSSSSSSSSSSSS............SSSSSSSSLLLLLLLLLLLLLLLLLLLLLLLLLLLLLLLLLLLLLLLLLLL
.....SS.SSSSSSSSSSSSSSSSSSSSSSSSSSLLLLLLLLSLLLLLSSSSSSSSSSSSSSSSS............SSSSSSSSLLLLLLLLLLLLLLLLLLLLLLLLLLLLLLLLLLLLLLLLLLL
...S.SS..SSSSSSSSSSSSSSSSSSSSSSSSLLLLLLLLLLLLLLLLLLLSSSSSSSSSSSSSS..........SSSSSSSLLLLLLLLLLLLLLLLLLLLLLLLLLLLLLLLLLLLLLLLLLLLL
S..S.SS..SSSSSSSSSSSSSSSSSSSSLLLLLLLLLLLLLLLLLLLLLLLLLLLSSSSSSSSSS.S.....SSSSSSSSSSSLLLLLLLLLLLLLLLLLLLLLLLLLLLLLLLLLLLLLLLLLLLL
S..S......SSSSSSSSSSSSSSSSSSLLLLLLLLLLLLLLLLLLLLLLLLLLLLLLSSSSSSSSSSS....SSSSSSSSSSSLLLLLLLLLLLLLLLLLLLLLLLLLLLLLLLLLLLLLLLLLLLL
S..........SSSSSSSSSSSSSSSSSLLLLLLLLLLLLLLLLLLLLLLLLLLLLLLLLLSSSSSSSSSSSSSSSSSSSSSSSLLLLLLLLLLLLLLLLLLLLLLLLLLLLLLLLLLLLLLLLLLLL
S..........SSSSSSSSSSSSSLLLLLLLLLLLLLLLLLLLLLLLLLLLLLLLLLLLLLLSSSSSSSSSSSSSSSSSSSSSSSLLLLLLLLLLLLLLLLLLLLLLLLLLLLLLLLLLLLLLLLLLL
S.........SSSSSSSSSSSSSLLLLLLLLLLLLLLLLLLLLLLLLLLLLLLLLLLLLLLLLLSSSSSSSSSSSSSSSSSSSLLLLLLLLLLLLLLLLLLLLLLLLLLLLLLLLLLLLLLLLLLLLL
S.......SSSSSSSSSSSSLLLLLLLLLLLLLLLLLLLLLLLLLLLLLLLLLLLLLLLLLLLLLSSSSSSSSSSSSSSSSLLLLLLLLLLLLLLLLLLLLLLLLLLLLLLLLLLLLLLLLLLLLLLL
S.....SSSSSSSSSSSSSSLLLLLLLLLLLLLLLLLLLLLLLLLLLLLLLLLLLLLLLLLLLLSSSSSSSSSSSSSSSSSLLLLLLLLLLLLLLLLLLLLLLLLLLLLLLLLLLLLLLLLLLLLLLL
.....SSSSSSSSSSSSSLLLLLLLLLLLLLLLLLLLLLLLLLLLLLLLLLLLLLLLLLLLLLLLLLSSSSSSSSSSSLLLLLLLLLLLLLLLLLLLLLLLLLLLLLLLLLLLLLLLLLLLLLLLLLL
....SSSSSSSSSSLLLLLLLLLLLLLLLLLLLLLLLLLLLLLLLLLLLLLLLLLLLLLLLLLLLLLLLLLSSSSSLLLLLLLLLLLLLLLLLLLLLLLLLLLLLLLLLLLLLLLLLLLLLLLLLLLL
....SSSSSSSSSLLLLLLLLLLLLLLLLLLLLLLLLLLLLLLLLLLLLLLLLLLLLLLLLLLLLLLLLLLLLSLLLLLLLLLLLLLLLLLLLLLLLLLLLLLLLLLLLLLLLLLLLLLLLLLLLLLL
....SSSSSSLLLLLLLLLLLLLLLLLLLLLLLLLLLLLLLLLLLLLLLLLLLLLLLLLLLLLLLLLLLLLLLLLLLLLLLLLLLLLLLLLLLLLLLLLLLLLLLLLLLLLLLLLLLLLLLLLLLLLL
....SSSSSSLLLLLLLLLLLLLLLLLLLLLLLLLLLLLLLLLLLLLLLLLLLLLLLLLLLLLLLLLLLLLLLLLLLLLLLLLLLLLLLLLLLLLLLLLLLLLLLLLLLLLLLLLLLLLLLLLLLLLL
...SSSSSSLSSLLLLLLLLLLLLLLLLLLLLLLLLLLLLLLLLLLLLLLLLLLLLLLLLLLLLLLLLLLLLLLLLLLLLLLLLLLLLLLLLLLLLLLLLLLLLLLLLLLLLLLLLLLLLLLLLLLLL
...SSSSSSLLLLLLLLLLLLLLLLLLLLLLLLLLLLLLLLLLLLLLLLLLLLLLLLLLLLLLLLLLLLLLLLLLLLLLLLLLLLLLLLLLLLLLLLLLLLLLLLLLLLLLLLLLLLLLLLLLLLLLL
..SSSSSSSSLLLLLLLLLLLLLLLLLLLLLLLLLLLLLLLLLLLLLLLLLLLLLLLLLLLLLLLLLLLLLLLLLLLLLLLLLLLLLLLLLLLLLLLLLLLLLLLLLLLLLLLLLLLLLLLLLLLLLL
..SSSSSSSLLLLLLLLLLLLLLLLLLLLLLLLLLLLLLLLLLLLLLLLLLLLLLLLLLLLLLLLLLLLLLLLLLLLLLLLLLLLLLLLLLLLLLLLLLLLLLLLLLLLLLLLLLLLLLLLLLLLLLL
..SSSSSSSLLLLLLLLLLLLLLLLLLLLLLLLLLLLLLLLLLLLLLLLLLLLLLLLLLLLLLLLLLLLLLLLLLLLLLLLLLLLLLLLLLLLLLLLLLLLLLLLLLLLLLLLLLLLLLLLLLLLLLL
.SSSSSSSSLLLLLLLLLLLLLLLLLLLLLLLLLLLLLLLLLLLLLLLLLLLLLLLLLLLLLLLLLLLLLLLLLLLLLLLLLLLLLLLLLLLLLLLLLLLLLLLLLLLLLLLLLLLLLLLLLLLLLLL
.SSSSSSSSLLLLLLLLLLLLLLLLLLLLLLLLLLLLLLLLLLLLLLLLLLLLLLLLLLLLLLLLLLLLLLLLLLLLLLLLLLLLLLLLLLLLLLLLLLLLLLLLLLLLLLLLLLLLLLLLLLLLLLL
.SSSSSSSSLLLLLLLLLLLLLLLLLLLLLLLLLLLLLLLLLLLLLLLLLLLLLLLLLLLLLLLLLLLLLLLLLLLLLLLLLLLLLLLLLLLLLLLLLLLLLLLLLLLLLLLLLLLLLLLLLLLLLLL
.SSSSSSSSLLLLLLLLLLLLLLLLLLLLLLLLLLLLLLLLLLLLLLLLLLLLLLLLLLLLLLLLLLLLLLLLLLLLLLLLLLLLLLLLLLLLLLLLLLLLLLLLLLLLLLLLLLLLLLLLLLLLLLL
..SSSSSSLLLLLLLLLLLLLLLLLLLLLLLLLLLLLLLLLLLLLLLLLLLLLLLLLLLLLLLLLLLLLLLLLLLLLLLLLLLLLLLLLLLLLLLLLLLLLLLLLLLLLLLLLLLLLLLLLLLLLLLL
..SSSSSSLLLLLLLLLLLLLLLLLLLLLLLLLLLLLLLLLLLLLLLLLLLLLLLLLLLLLLLLLLLLLLLLLLLLLLLLLLLLLLLLLLLLLLLLLLLLLLLLLLLLLLLLLLLLLLLLLLLLLLLL
..SSSSSSLLLLLLLLLLLLLLLLLLLLLLLLLLLLLLLLLLLLLLLLLLLLLLLLLLLLLLLLLLLLLLLLLLLLLLLLLLLLLLLLLLLLLLLLLLLLLLLLLLLLLLLLLLLLLLLLLLLLLLLL
..SSSSSSLLLLLLLLLLLLLLLLLLLLLLLLLLLLLLLLLLLLLLLLLLLLLLLLLLLLLLLLLLLLLLLLLLLLLLLLLLLLLLLLLLLLLLLLLLLLLLLLLLLLLLLLLLLLLLLLLLLLLLLL
...SSSSSSLLLLLLLLLLLLLLLLLLLLLLLLLLLLLLLLLLLLLLLLLLLLLLLLLLLLLLLLLLLLLLLLLLLLLLLLLLLLLLLLLLLLLLLLLLLLLLLLLLLLLLLLLLLLLLLLLLLLLLL
...SSSSSSLLLLLLLLLLLLLLLLLLLLLLLLLLLLLLLLLLLLLLLLLLLLLLLLLLLLLLLLLLLLLLLLLLLLLLLLLLLLLLLLLLLLLLLLLLLLLLLLLLLLLLLLLLLLLLLLLLLLLLL
....SSSSSLLLLLLLLLLLLLLLLLLLLLLLLLLLLLLLLLLLLLLLLLLLLLLLLLLLLLLLLLLLLLLLLLLLLLLLLLLLLLLLLLLLLLLLLLLLLLLLLLLLLLLLLLLLLLLLLLLLLLLL
.S..SSSSSLLLLLLLLLLLLLLLLLLLLLLLLLLLLLLLLLLLLLLLLLLLLLLLLLLLLLLLLLLLLLLLLLLLLLLLLLLLLLLLLLLLLLLLLLLLLLLLLLLLLLLLLLLLLLLLLLLLLLLL
.S..SSSSSSLLLLLLLLLLLLLLLLLLLLLLLLLLLLLLLLLLLLLLLLLLLLLLLLLLLLLLLLLLLLLLLLLLLLLLLLLLLLLLLLLLLLLLLLLLLLLLLLLLLLLLLLLLLLLLLLLLLLLL
