CCCCCCCCCCCCCCCCCCCCCCCCCCCCCCCCCCCCCCCCCCCCCCCCCCCCCCCCCCCCCCCCCCCCCCCCCCCCCCCCCCCCCCCCCCCCCCCCCCCCCCCCCCCCCCCCCCCCCCCCCCCCCCCC
CLLLLLLLLLLLLLLLLLLLLLLLLLLLLLLLLLLLLLLLLLLLLLLLLLLLLLLLLLLLLLLLLLLLLLLLLLLLLLLLLLLLLLLLLLLLLLLLLLLLLLLLLLLLLLLLLLLLLLLLLLLLLLLC
CLLLLLLLLLLLLLLLLLLLLLLLLLLLLLLLLLLLLLLLLLLLLLLLLLLLLLLLLLLLLLLLLLLLLLLLLLLLLLLLLLLLLLLLLLLLLLLLLLLLLLLLLLLLLLLLLLLLLLLLLLLLLLLC
CLLLLLLLLLLLLLLLLLLLLLLLLLLLLLLLLLLLLLLLLLLLLLLLLLLLLLLLLLLLLLLLLLLLLLLLLLLLLLLLLLLLLLLLLLLLLLLLLLLLLLLLLLLLLLLLLLLLLLLLLLLLLLLC
CLLLLLLLLLLLLLLLLLLLLLLLLLLLLLLLLLLLLLLLLLLLLLLLLLLLLLLLLLLLLLLLLLLLLLLLLLLLLLLLLLLLLLLLLLLLLLLLLLLLLLLLLLLLLLLLLLLLLLLLLLLLLLLC
CLLLLLLLLLLLLLLLLLLLLLLLLLLLLLLLLLLLLLLLLLLLLLLLLLLLLLLLLLLLLLLLLLLLLLLLLLLLLLLLLLLLLLLLLLLLLLLLLLLLLLLLLLLLLLLLLLLLLLLLLLLLLLLC
CLLLLLLLLLLLLLLLLLLLLLLLLLLLLLLLLLLLLLLLLLLLLLLLLLLLLLLLLLLLLLLLLLLLLLLLLLLLLLLLLLLLLLLLLLLLLLLLLLLLLLLLLLLLLLLLLLLLLLLLLLLLLLLC
CLLLLLLLLLLLLLLLLLLLLLLLLLLLLLLLLLLLLLLLLLLLLLLLLLLLLLLLLLLLLLLLLLLLLLLLLLLLLLLLLLLLLLLLLLLLLLLLLLLLLLLLLLLLLLLLLLLLLLLLLLLLLLLC
CLLLLLLLLLLLLLLLLLLLLLLLLLLLLLLLLLLLLLLLLLLLLLLLLLLLLLLLLLLLLLLLLLLLLLLLLLLLLLLLLLLLLLLLLLLLLLLLLLLLLLLLLLLLLLLLLLLLLLLLLLLLLLLC
CLLLLLLLLLLLLLLLLLLLLLLLLLLLLLLLLLLLLLLLLLLLLLLLLLLLLLLLLLLLLLLLLLLLLLLLLLLLLLLLLLLLLLLLLLLLLLLLLLLLLLLLLLLLLLLLLLLLLLLLLLLLLLLC
CLLLLLLLLLLLLLLLLLLLLLLLLLLLLLLLLLLLLLLLLLLLLLLLLLLLLLLLLLLLLLLLLLLLLLLLLLLLLLLLLLLLLLLLLLLLLLLLLLLLLLLLLLLLLLLLLLLLLLLLLLLLLLLC
CLLLLLLLLLLLLLLLLLLLLLLLLLLLLLLLLLLLLLLLLLLLLLLLLLLLLLLLLLLLLLLLLLLLLLLLLLLLLLLLLLLLLLLLLLLLLLLLLLLLLLLLLLLLLLLLLLLLLLLLLLLLLLLC
CLLLLLLLLLLLLLLLLLLLLLLLLLLLLLLLLLLLLLLLLLLLLLLLLLLLLLLLLLLLLLLLLLLLLLLLLLLLLLLLLLLLLLLLLLLLLLLLLLLLLLLLLLLLLLLLLLLLLLLLLLLLLLLC
CLLLLLLLLLLLLLLLLLLLLLLLLLLLLLLLLLLLLLLLLLLLLLLLLLLLLLLLLLLLLLLLLLLLLLLLLLLLLLLLLLLLLLLLLLLLLLLLLLLLLLLLLLLLLLLLLLLLLLLLLLLLLLLC
CLLLLLLLLLLLLLLLLLLLLLLLLLLLLLLLLLLLLLLLLLLLLLLLLLLLLLLLLLLLLLLLLLLLLLLLLLLLLLLLLLLLLLLLLLLLLLLLLLLLLLLLLLLLLLLLLLLLLLLLLLLLLLLC
CLLLLLLLLLLLLLLLLLLLLLLLLLLLLLLLLLLLLLLLLLLLLLLLLLLLLLLLLLLLLLLLLLLLLLLLLLLLLLLLLLLLLLLLLLLLLLLLLLLLLLLLLLLLLLLLLLLLLLLLLLLLLLLC
CLLLLLLLLLLLLLLLLLLLLLLLLLLLLLLLLLLLLLLLLLLLLLLLLLLLLLLLLLLLLLLLLLLLLLLLLLLLLLLLLLLLLLLLLLLLLLLLLLLLLLLLLLLLLLLLLLLLLLLLLLLLLLLC
CLLLLLLLLLLLLLLLLLLLLLLLLLLLLLLLLLLLLLLLLLLLLLLLLLLLLLLLLLLLLLLLLLLLLLLLLLLLLLLLLLLLLLLLLLLLLLLLLLLLLLLLLLLLLLLLLLLLLLLLLLLLLLLC
CLLLLLLLLLLLLLLLLLLLLLLLLLLLLLLLLLLLLLLLLLLLLLLLLLLLLLLLLLLLLLLLLLLLLLLLLLLLLLLLLLLLLLLLLLLLLLLLLLLLLLLLLLLLLLLLLLLLLLLLLLLLLLLC
CLLLLLLLLLLLLLLLLLLLLLLLLLLLLLLLLLLLLLLLLLLLLLLLLLLLLLLLLLLLLLLLLLLLLLLLLLLLLLLLLLLLLLLLLLLLLLLLLLLLLLLLLLLLLLLLLLLLLLLLLLLLLLLC
CLLLLLLLLLLLLLLLLLLLLLLLLLLLLLLLLLLLLLLLLLLLLLLLLLLLLLLLLLLLLLLLLLLLLLLLLLLLLLLLLLLLLLLLLLLLLLLLLLLLLLLLLLLLLLLLLLLLLLLLLLLLLLLC
CLLLLLLLLLLLLLLLLLLLLLLLLLLLLLLLLLLLLLLLLLLLLLLLLLLLLLLLLLLLLLLLLLLLLLLLLLLLLLLLLLLLLLLLLLLLLLLLLLLLLLLLLLLLLLLLLLLLLLLLLLLLLLLC
CLLLLLLLLLLLLLLLLLLLLLLLLLLLLLLLLLLLLLLLLLLLLLLLLLLLLLLLLLLLLLLLLLLLLLLLLLLLLLLLLLLLLLLLLLLLLLLLLLLLLLLLLLLLLLLLLLLLLLLLLLLLLLLC
CLLLLLLLLLLLLLLLLLLLLLLLLLLLLLLLLLLLLLLLLLLLLLLLLLLLLLLLLLLLLLLLLLLLLLLLLLLLLLLLLLLLLLLLLLLLLLLLLLLLLLLLLLLLLLLLLLLLLLLLLLLLLLLC
CLLLLLLLLLLLLLLLLLLLLLLLLLLLLLLLLLLLLLLLLLLLLLLLLLLLLLLLLLLLLLLLLLLLLLLLLLLLLLLLLLLLLLLLLLLLLLLLLLLLLLLLLLLLLLLLLLLLLLLLLLLLLLLC
CLLLLLLLLLLLLLLLLLLLLLLLLLLLLLLLLLLLLLLLLLLLLLLLLLLLLLLLLLLLLLLLLLLLLLLLLLLLLLLLLLLLLLLLLLLLLLLLLLLLLLLLLLLLLLLLLLLLLLLLLLLLLLLC
CLLLLLLLLLLLLLLLLLLLLLLLLLLLLLLLLLLLLLLLLLLLLLLLLLLLLLLLLLLLLLLLLLLLLLLLLLLLLLLLLLLLLLLLLLLLLLLLLLLLLLLLLLLLLLLLLLLLLLLLLLLLLLLC
CLLLLLLLLLLLLLLLLLLLLLLLLLLLLLLLLLLLLLLLLLLLLLLLLLLLLLLLLLLLLLLLLLLLLLLLLLLLLLLLLLLLLLLLLLLLLLLLLLLLLLLLLLLLLLLLLLLLLLLLLLLLLLLC
CLLLLLLLLLLLLLLLLLLLLLLLLLLLLLLLLLLLLLLLLLLLLLLLLLLLLLLSSSSSSLLLLLLLLLLLLLLLLLLLLLLLLLLLLLLLLLLLLLLLLLLLLLLLLLLLLLLLLLLLLLLLLLLC
CLLLLLLLLLLLLLLLLLLLLLLLLLLLLLLLLLLLLLLLLLLLLLLLLLSSSSSSSCCCCCSSSSLLLLLLLLLLLLLLLLLLLLLLLLLLLLLLLLLLLLLLLLLLLLLLLLLLLLLLLLLLLLLC
CLLLLLLLLLLLLLLLLLLLLLLLLLLLLLLLLLLLLLLLLLLLLLLLLSSSSSCCCCSSSCCCSSSSLLLLLLLLLLLLLLLLLLLLLLLLLLLLLLLLLLLLLLLLLLLLLLLLLLLLLLLLLLLC
CLLLLLLLLLLLLLLLLLLLLLLLLLLLLLLLLLLLLLLLLLLLLLSSCCCCCCCSSSSSSSSCCCCSSSSSSSLLLLLSSLLLLLLLLLLLLLLLLLLLLLLLLLLLLLLLLLLLLLLLLLLLLLLC
CLLLLLLLLLLLLLLLLLLLLLLLLLLLLLLLLLLLLLLLLLLLSSSCCSSSSSSSSSSSSSSSSSCCCCCCSSSSSSSSSSSSSSLLLLLLLLLLLLLLLLLLLLLLLLLLLLLLLLLLLLLLLLLC
CLLLLLLLLLLLLLLLLLLLLLLLLLLLLLLLLLLLLLLLLLLLSSCCSSSSSSSSSSSSSSSSSSSSSSSCCCCSSSSCCCCCSSLLLLLLLLLLLLLLLLLLLLLLLLLLLLLLLLLLLLLLLLLC
CLLLLLLLLLLLLLLLLLLLLLLLLLLLLLLLLLLLLLLLLLLSSCCSSSSSSSSSSSSSSSSSSSSSSSSSSSCCCCCCSSSCSSSLLLLLLLLLLLLLLLLLLLLLLLLLLLLLLLLLLLLLLLLC
CLLLLLLLLLLLLLLLLLLLLLLLLLLLLLLLLLLLLLLLLLSSCCSSSS.SSSSSSSSSSSSSSSSSS.SSSSSSSSSSSSSCSSSLLLLLLLLLLLLLLLLLLLLLLLLLLLLLLLLLLLLLLLLC
CLLLLLLLLLLLLLLLLLLLLLLLLLLLLLLLLLLLLLLLLLSSCSSSSSSSSSSSSSSSSSSSSSSSSSSSSSSSSSSSSSSCSSLLLLLLLSSLLLLLLLLLLLLLLLLLLLLLLLLLLLLLLLLC
CLLLLLLLLLLLLLLLLLLLLLLLLLLLLLLLLLLLLLLLLSSCCSSSSSSSSSSSSSSSSSSSSSSSSSSS......SSSSSCSSLLLLLSSSSSSSLLLLLLLLLLLLLLLLLLLLLLLLLLLLLC
CLLLLLLLLLLLLLLLLLLLLLLLLLLLLLLLLLLLLLLLSSCCSSSSSSSSSSSSSSSSSSSSSSSSSSSSSS.....SSSSCSSLLLLSSCCCCSSSSSLLLLLLLLLLLLLLLLLLLLLLLLLLC
CLLLLLLLLLLLLLLLLLLLLLLLLLLLLLLLLLLLLLLLSSCSSSSSSSSSSSSSSSSSSSSSSSSSSSSSSSSSS..SSSSCSSSLSSSCCSSCCSSSSSLLLLLLLLLLLLLLLLLLLLLLLLLC
CLLLLLLLLLLLLLLLLLLLLLLLLLLLLLLLLLLLLLLLLCCSSSSSSSSSSSSSSSSSSSSSSSSSSSSSSSSSSSS.SSSCCSSSSCCCSSSSCCCSSSLLLLLLLLLLLLLLLLLLLLLLLLLC
CLLLLLLLLLLLLLLLLLLLLSSSSSLLLLLLLLLLLLLSSCSSSSSSSSSSSSSSSSSSSSSSSSSSSSSSSSSSSSSSSSSSCCCSCCSSSSSSSSCSSSLLLLLLLLLLLLLLLLLLLLLLLLLC
CLLLLLLLLLLLLLLLLLLLSSSSSSLLLLLLLLLLLLLSSCSSSSSSSSSSSSSSSSSSSSSSSSSSSSSSSSSSSSSSSSSSSSCCCSSSSSSSSCCSSSLLLLLLLLLLLLLLLLLLLLLLLLLC
CLLLLLLLLLLLLLLLLLLLSCCCCSSLLLLLLLLLLLLSSCSSSSSSSSSSSSSSSSSSSSSSSSSSSSSSSSSSSSSSSSSSSSSSSSSSS.SSSCSSSSLLLLLLLLLLLLLLLLLLLLLLLLLC
CLLLLLLLLLLLLLLLLLSSCCSSCSSLLLLLLLLLLLLSSCSSSSSSSSSSSSSSSSSSSSSSSSSSSSSSSSSSSSSSS.SSSSSSSSSS...SCCSSSLLLLLLLLLLLLLLLLLLLLLLLLLLC
CLLLLLLLLLLLLLLLLSSCCSSSCCSSLLLLLLLLLLLSSCSSSSSSSSSSSSSSSSSSSSSSSSSSSSSSSSSSSSSSS...SSSSSSS...SSCSSSLLLLLLLLLLLLLLLLLLLLLLLLLLLC
CLLLLLLLLLLLLLLLLSCCSSSSSCCSSLLLLLLLLLLSCCSSSSSSSSSSSSSSSSSSSSSSSSSSSSSSSSSSSSSSS............SSCCSLLLLLLLLLLLLLLLLLLLLLLLLLLLLLC
CLLLLLLLLLLLLLLLLSCSSSSSSSCSSSLLLLLLLLSSCSSSSSSSSSSSSSSSSSSSSSSSSSSSSSSSSSSSSSSSS..........SSSSCSSLLLLLLLLLLLLLLLLLLLLLLLLLLLLLC
CLLLLLLLLLLLLLLLLSCSSSSSSSCCSSLLLLLLLLSCCSSSSSSSSSSSSSSSSSSSSSSSSSSSSSSSSSSSSSSSS.........SSSSCCSSLLLLLLLLLLLLLLLLLLLLLLLLLLLLLC
CLLLLLLLLLLLLLLLLSCCSSSSSSSCCSSSLLLLLLSCSSSSSSSSSSSSSSSSSSSSSSSSSSSSSSSSSSSSSSSSS.........SSSCCSSLLLLLLLLLLLLLLLLLLLLLLLLLLLLLLC
CLLLLLLLLLLLLLLLLSSCSSSSSSSSCCCSSLLLLSSCSSSSSSSSSSSSSSSSSSSSSSSSSSSSSSSSSSSSSSSSSSS......SSSSCSSSLLLLLLLLLLLLLLLLLLLLLLLLLLLLLLC
CLLLLLLLLLLLLLLLLSSCSSSSSSSSSSCCSSSSSSCCSSSSSSSSSSSSSSSSSSSSSSSSSSSSSSSSSSSSSSSSSSSS.....SSSCCSSSLLLLLLLLLLLLLLLLLLLLLLLLLLLLLLC
CLLLLLLLLLLLLLLLLSSCSSSSSSSSSSSCCCSSCCCSSSSSSSSSSSSSSSSSSSSSSSSSSSSSSSSSSSSSSSSSSSSS.....SSCCSSSLLLLLLLLLLLLLLLLLLLLLLLLLLLLLLLC
CLLLLLLLLLLLLLLLLSSCSSSSSSSSSSSSSCCCCSSSSSSSSSSSSSSSSSSSSSSSSCCCSSSSSSSSSSSSSSSSSSSS....SSCCSSSSLLLLLLLLLLLLLLLLLLLLLLLLLLLLLLLC
CLLLLLLLLLLLLLLLLLSCSSSSSSSSSSSSSSSSSSSSSSSSSSSSSSSSSSSSSSCCCCSCCSSSSSSSSSSSSSSSSSSS....SSCSSLSLLLLLLLLLLLLLLLLLLLLLLLLLLLLLLLLC
CLLLLLLLLLLLLLLLLLSCSSSS..SS.SSSSSSSSSSSS.SSSSSSSSSSSSSCCCCSSSSSCCSSSSSSSSSSSSSSSSSS....SCCSSLLLLLLLLLLLLLLLLLLLLLLLLLLLLLLLLLLC
CLLLLLLLLLLLLLLLLLSCCSSSSSSS.SSSSSSSSSSSS.S...SSSSSCCCCCSSSSLLLSSCSSSSSSSSSSSSSSSSSS...SSCSSSLLLLLLLLLLLLLLLLLLLLLLLLLLLLLLLLLLC
CLLLLLLLLLLLLLLLLLSSCSSSSSSS...SSSSSSSSSS.S.SSSSSCCCSSSSSSLLLLLSSCSS.SSSSSSSSSSSSSSS...SSCSSLLLLLLLLLLLLLLLLLLLLLLLLLLLLLLLLLLLC
CLLLLLLLLLLLLLLLLLSSCSSSSSSSS....SSSSSSSS.SSSSSSCCSSSLLLLLLLLLLSSCCSSSSSSSSSSSSSSSS...SSSCSSSLLLLLLLLLLLLLLLLLLLLLLLLLLLLLLLLLLC
CLLLLLLLLLLLLLLLLLSSCCSSSSSSSSSSSSSSSSSSSSSSSSSCCSSLLLLLLLLLLLLSSSCSS.SSSSSSSSSSSS...SSSCCSSLLLLLLLLLLLLLLLLLLLLLLLLLLLLLLLLLLLC
CLLLLLLLLLLLLLLLLLLSSCCCCSSSSSSSSSSSSSSS.SSSSSSCSSSLLLLLLLLLLLLLSSCSS...SSSSSSSS.....SSCCSSSLLLLLLLLLLLLLLLLLLLLLLLLLLLLLLLLLLLC
CLLLLLLLLLLLLLLLLLLLSSSSCCSSSSSSSSSSSSSS.SSSSSCCSLLLLLLLLLLLLLLLSCCSS....SSSSSS.....SSCCSSSSLLLLLLLLLLLLLLLLLLLLLLLLLLLLLLLLLLLC
CLLLLLLLLLLLLLLLLLLLLLSSSCCSSSSSSSSSSSS..SSSSCCSSLLLLLLLLLLLLLLSSCSSS......SS......SSSCSSSSLLLLLLLLLLLLLLLLLLLLLLLLLLLLLLLLLLLLC
CLLLLLLLLLLLLLLLLLLLLLLSSSCCSSSSSSSSSS..SSSSCCSLLLLLLLLLLLLLLLLSCCSSS.............SSSCCSSSLLLLLLLLLLLLLLLLLLLLLLLLLLLLLLLLLLLLLC
CLLLLLLLLLLLLLLLLLLLLLLLLSSCSSSSSSSSSS..SSSSCSLLLLLLLLLLLLLLLLSSCSSSS............SSSSCSSSSLLLLLLLLLLLLLLLLLLLLLLLLLLLLLLLLLLLLLC
CLLLLLLLLLLLLLLLLLLLLLLLLSSCSSSSSSSSSS.SSSSCCLLLLLLLLLLLLLLLLSSCCSSSSSS..........SSSCCSSSSLLLLLLLLLLLLLLLLLLLLLLLLLLLLLLLLLLLLLC
CLLLLLLLLLLLLLLLLLLLLLLLLSSCSSSSSSSSSS.SSSSCSLLLLLLLLLLLLLLSSSCCSSSSSSSS.......SSSSCCSSSSLLLLLLLLLLLLLLLLLLLLLLLLLLLLLLLLLLLLLLC
CLLLLLLLLLLLLLLLLLLLLLLLSSSCSSSSSSSSSS.SSSCCSSLLLLLLLLLSSSSSCCCSSSSSSSSSS.....SSSSCCSSLLLLLLLLLLLLLLLLLLLLLLLLLLLLLLLLLLLLLLLLLC
CLLLLLLLLLLLLLLLLLLLLLLLSSCCSSSSSSSSSSSSSCCSSLLLLLLLLLLSCCCCCSSSSSSSSSSSS...SSSSSCCSSLLLLLLLLLLLLLLLLLLLLLLLLLLLLLLLLLLLLLLLLLLC
CLLLLLLLLLLLLLLLLLLLLLLLSSCSSSSSSSSSSSSSSCSSLLLLLLLLLLSSCSSSSSSSSSSSSSSSSSSSSSSCCCSSSLLLLLLLLLLLLLLLLLLLLLLLLLLLLLLLLLLLLLLLLLLC
CLLLLLLLLLLLLLLLLLLLLLLSSSCSSSSSSSSSSSSSSCSSLLLLLLLLLLSCCSSSSSSSSSSSSSSSSSSSSSCCSSSSLLLLLLLLLLLLLLLLLLLLLLLLLLLLLLLLLLLLLLLLLLLC
CLLLLLLLLLLLLLLLLLLLLLLSSSCSSSSSSSSSSSSSSCSLLLLLLLLLLSSCSSSSSSSSSSSSSSSSSSSSSCCSSSLLLSLSSSLLLLLLLLLLLLLLLLLLLLLLLLLLLLLLLLLLLLLC
CLLLLLLLLLLLLLLLLLLLLLLSSSCSSSSSSSSSSSSSCCSSLLLLLLLLLSSCSSS..SSSSSSSSSSSSSSCCCSSSLLLLSSSSSLLLLLLLLLLLLLLLLLLLLLLLLLLLLLLLLLLLLLC
CLLLLLLLLLLLLLLLLLLLLLLLSSCSSSSSSSSSSSSSCSSLLLLLLLLLLSSCSSS.SSSSSSSSSSSSSSCCSSSLLLLSSCCCSSLLLLLLLLLLLLLLLLLLLLLLLLLLLLLLLLLLLLLC
CLLLLLLLLLLLLLLLLLLLLLLLLSCCSSSSSSSSSSSSCSSLLLLLLLLLLSCCSSSSSSSSSSSSSSSSSSCSSLLLLLSSCCSCSSLLLLLLLLLLLLLLLLLLLLLLLLLLLLLLLLLLLLLC
CLLLLLLLLLLLLLLLLLLLLLLLLSSCSSSSSSSSSSSSCSSLLLLLLLLLLSCSSSSSSSSSSSSSSSSSSSCSLLLLLSSCCSSCSLLLLLLLLLLLLLLLLLLLLLLLLLLLLLLLLLLLLLLC
CLLLLLLLLLLLLLLLLLLLLLLLLLSCCSSSSSSSSSSSCSSLLLLLLLLLSCCSSSSSSSSSSSSSSSSSSSCSLLLLLSSCSSCCLLLLLLLLLLLLLLLLLLLLLLLLLLLLLLLLLLLLLLLC
CLLLLLLLLLLLLLLLLLLLLLLLLLSSCCSSSSSSSSSSCSSSLLLLLLLSCCSSSSSSSSSSSSSSSSSSSSCSLLLLSSCCSCCSSLLLLLLLLLLLLLLLLLLLLLLLLLLLLLLLLLLLLLLC
CLLLLLLLLLLLLLLLLLLLLLLLLLLSSCCSSSSSSSSSCCSSLLLLLSSCCSSSSSSSSSSSSSSSSSSSSSCSSSLSSCCSCCSLLLLLLLLLLLLLLLLLLLLLLLLLLLLLLLLLLLLLLLLC
CLLLLLLLLLLLLLLLLLLLLLLLLLLSSSCCSSSSSSSSSCCSLLSSSSCCSSSSSSSSSSSSSSSSSSSSSSCCSSSSCCSCCSSLLLLLLLLLLLLLLLLLLLLLLLLLLLLLLLLLLLLLLLLC
CLLLLLLLLLLLLLLLLLLLLLLLLLLLSSSCCSSSSSSSSSCSSSSSCCCSSSSSSSSSSCCCCCSSSSSSSSSCCSSCCSSCSSLLLLLLLLLLLLLLLLLLLLLLLLLLLLLLLLLLLLLLLLLC
CLLLLLLLLLLLLLLLLLLLLLLLLLLLLSSSCSSSSSSSSSCCCCCCCSSSSSSSSSSSSCSSSCSSSSSSSSSSCCCCSSSCCSSLLLLLLLLLLLLLLLLLLLLLLLLLLLLLLLLLLLLLLLLC
CLLLLLLLLLLLLLLLLLLLLLLLLLLLLLSSCCSSSSSSSSSSSSSSSSSSSSSSSSSSCCSSSCCSSSSSSSSSSSSSSSSSCCSSSLLLLLLLLLLLLLLLLLLLLLLLLLLLLLLLLLLLLLLC
CLLLLLLLLLLLLLLLLLLLLLLLLLLLLLLSSCCSSSSSSSSSSSSSSSSSSSSSSSSCCSSLSSCSSSSSSSSSSSSSSSSSSCSSSSLLLLLLLLLLLLLLLLLLLLLLLLLLLLLLLLLLLLLC
CLLLLLLLLLLLLLLLLLLLLLLLLLLLLLLSSSCSSSSSSSSSSSSSSSSSSSSSSSSCSSLSSSCSSCCCCCCSSSSSSSSSSCSSSSLLLLLLLLLLLLLLLLLLLLLLLLLLLLLLLLLLLLLC
CLLLLLLLLLLLLLLLLLLLLLLLLLLLLLLLSSCSSSSSSSSSSSSSSSSSSSSSSSCCSLLLSSCCCCSSSSCCCCSSSSSSCCSSSSLLLLLLLLLLLLLLLLLLLLLLLLLLLLLLLLLLLLLC
CLLLLLLLLLLLLLLLLLLLLLLLLLLLLLLLSSCSSSSSSSSSSCCCCCSSSSSSSSCSLLLLSSSSSSSSLSSSSCCSSSSCCSSSSLLLLLLLLLLLLLLLLLLLLLLLLLLLLLLLLLLLLLLC
CLLLLLLLLLLLLLLLLLLLLLLLLLLLLLLSSCCSSSSSSSSSCCSSSCCSSSSSSCCSLLLLLLSSSSSLLLLLSSCCCSSCSSLLLLLLLLLLLLLLLLLLLLLLLLLLLLLLLLLLLLLLLLLC
CLLLLLLLLLLLLLLLLLLLLLLLLLLLLLSSSCSSSSSSSSSCCSSSSSCCSSSSCCSSLLLLLLLSSLLLLLLLLLSSCCCCSSLLLLLLLLLLLLLLLLLLLLLLLLLLLLLLLLLLLLLLLLLC
CLLLLLLLLLLLLLLLLLLLLLLLLLLLLLSSCCSSSSSSSSCCSSSLLLSCCSSSCSSSLLLLLLLLLLLLLLLLLLLLSSSSSLLLLLLLLLLLLLLLLLLLLLLLLLLLLLLLLLLLLLLLLLLC
CLLLLLLLLLLLLLLLLLLLLLLLLLLLLLSSCSSSSSSSSCCSSSLLLLLSCCCCCSSLLLLLLLLLLLLLLLLLLLLLLLSSSLLLLLLLLLLLLLLLLLLLLLLLLLLLLLLLLLLLLLLLLLLC
CLLLLLLLLLLLLLLLLLLLLLLLLLLLLLSCCSSSSSSCCCSSSLLLLLLLSSSSSLLLLLLLLLLLLLLLLLLLLLLLLLLLLLLLLLLLLLLLLLLLLLLLLLLLLLLLLLLLLLLLLLLLLLLC
CLLLLLLLLLLLLLLLLLLLLLLLLLLLLLSCSSSSSSCCSSSLLLLLLLLLLSSSLLLLLLLLLLLLLLLLLLLLLLLLLLLLLLLLLLLLLLLLLLLLLLLLLLLLLLLLLLLLLLLLLLLLLLLC
CLLLLLLLLLLLLLLLLLLLLLLLLLLLLLSCCSSSSCCSSSSLLLLLLLLLLLSLLLLLLLLLLLLLLLLLLLLLLLLLLLLLLLLLLLLLLLLLLLLLLLLLLLLLLLLLLLLLLLLLLLLLLLLC
CLLLLLLLLLLLLLLLLLLLLLLLLLLLLLSSCSSSSCSSSLLLLLLLLLLLLLLLLLLLLLLLLLLLLLLLLLLLLLLLLLLLLLLLLLLLLLLLLLLLLLLLLLLLLLLLLLLLLLLLLLLLLLLC
CLLLLLLLLLLLLLLLLLLLLLLLLLLLLLSSCSSSSCCSSLLLLLLLLLLLLLLLLLLLLLLLLLLLLLLLLLLLLLLLLLLLLLLLLLLLLLLLLLLLLLLLLLLLLLLLLLLLLLLLLLLLLLLC
CLLLLLLLLLLLLLLLLLLLLLLLLLLLLLSSCCSSSSCSSSLLLLLLLLLLLLLLLLLLLLLLLLLLLLLLLLLLLLLLLLLLLLLLLLLLLLLLLLLLLLLLLLLLLLLLLLLLLLLLLLLLLLLC
CLLLLLLLLLLLLLLLLLLLLLLLLLLLLLLSSCSSSSCSSSLLLLLLLLLLLLLLLLLLLLLLLLLLLLLLLLLLLLLLLLLLLLLLLLLLLLLLLLLLLLLLLLLLLLLLLLLLLLLLLLLLLLLC
CLLLLLLLLLLLLLLLLLLLLLLLLLLLLLLSSCSSSSCCSSLLLLLLLLLLLLLLLLLLLLLLLLLLLLLLLLLLLLLLLLLLLLLLLLLLLLLLLLLLLLLLLLLLLLLLLLLLLLLLLLLLLLLC
CLLLLLLLLLLLLLLLLLLLLLLLLLLLLLLSSCCSSSSCSSSLLLLLLLLLLLLLLLLLLLLLLLLLLLLLLLLLLLLLLLLLLLLLLLLLLLLLLLLLLLLLLLLLLLLLLLLLLLLLLLLLLLLC
CLLLLLLLLLLLLLLLLLLLLLLLLLLLLLLLSSCSSSSCCSSLLLLLLLLLLLLLLLLLLLLLLLLLLLLLLLLLLLLLLLLLLLLLLLLLLLLLLLLLLLLLLLLLLLLLLLLLLLLLLLLLLLLC
CLLLLLLLLLLLLLLLLLLLLLLLLLLLLLLLSSCCSSSSCSSSLLLLLLLLLLLLLLLLLLLLLLLLLLLLLLLLLLLLLLLLLLLLLLLLLLLLLLLLLLLLLLLLLLLLLLLLLLLLLLLLLLLC
CLLLLLLLLLLLLLLLLLLLLLLLLLLLLLLLSSSCSSSSCCSSLLLLLLLLLLLLLLLLLLLLLLLLLLLLLLLLLLLLLLLLLLLLLLLLLLLLLLLLLLLLLLLLLLLLLLLLLLLLLLLLLLLC
CLLLLLLLLLLLLLLLLLLLLLLLLLLLLLLLSSSCSSSSSCSSLLLLLLLLLLLLLLLLLLLLLLLLLLLLLLLLLLLLLLLLLLLLLLLLLLLLLLLLLLLLLLLLLLLLLLLLLLLLLLLLLLLC
CLLLLLLLLLLLLLLLLLLLLLLLLLLLLLLLLSSCSSSSSCSSLLLLLLLLLLLLLLLLLLLLLLLLLLLLLLLLLLLLLLLLLLLLLLLLLLLLLLLLLLLLLLLLLLLLLLLLLLLLLLLLLLLC
CLLLLLLLLLLLLLLLLLLLLLLLLLLLLLLLLSSCSSSSSCSSLLLLLLLLLLLLLLLLLLLLLLLLLLLLLLLLLLLLLLLLLLLLLLLLLLLLLLLLLLLLLLLLLLLLLLLLLLLLLLLLLLLC
CLLLLLLLLLLLLLLLLLLLLLLLLLLLLLLLLSSCSSSSSCSSLLLLLLLLLLLLLLLLLLLLLLLLLLLLLLLLLLLLLLLLLLLLLLLLLLLLLLLLLLLLLLLLLLLLLLLLLLLLLLLLLLLC
CLLLLLLLLLLLLLLLLLLLLLLLLLLLLLLLLSSCSSSSSCSSSLLLLLLLLLLLLLLLLLLLLLLLLLLLLLLLLLLLLLLLLLLLLLLLLLLLLLLLLLLLLLLLLLLLLLLLLLLLLLLLLLLC
CLLLLLLLLLLLLLLLLLLLLLLLLLLLLLLLLSSCSSSSSCCSSLLLLLLLLLLLLLLLLLLLLLLLLLLLLLLLLLLLLLLLLLLLLLLLLLLLLLLLLLLLLLLLLLLLLLLLLLLLLLLLLLLC
CLLLLLLLLLLLLLLLLLLLLLLLLLLLLLLLLSSCSSSSSSCSSLLLLLLLLLLLLLLLLLLLLLLLLLLLLLLLLLLLLLLLLLLLLLLLLLLLLLLLLLLLLLLLLLLLLLLLLLLLLLLLLLLC
CLLLLLLLLLLLLLLLLLLLLLLLLLLLLLLLLSSCSSSSSCCSSLLLLLLLLLLLLLLLLLLLLLLLLLLLLLLLLLLLLLLLLLLLLLLLLLLLLLLLLLLLLLLLLLLLLLLLLLLLLLLLLSLC
CLLLLLLLLLLLLLLLLLLLLLLLLLLLLLLLLSSCSSSSSCCSSLLLLLLLLLLLLLLLLLLLLLLLLLLLLLLLLLLLLLLLLLLLLLLLLLLLLLLLLLLLLLLLLLLLLLLLLLLLSSSSSSSC
CLLLLLLLLLLLLLLLLLLLLLLLLLLLLLLLLSSCSSSSSSCSSLLLLLLLLLLLLLLLLLLLLLLLLLLLLLLLLLLLLLLLLLLLLLLLLLLLLLLLLLLLLLLLLLLLLLLLSSSSSSSSCCCC
CLLLLLLLLLLLLLLLLLLLLLLLLLLLLLLLLSSCSSSSSSCSSSLLLLLLLLLLLLLLLLLLLLLLLLLLLLLLLLLLLLLLLLLLLLLLLLLLLLLLLLLLLLLLLLLSSSSSSSCCCCCCCSSS
CLLLLLLLLLLLLLLLLLLLLLLLLLLLLLLLLSSCSSSSSSCCSSLLLLLLLLLLLLLLLLLLLLLLLLLLLLLLLLLLLLLLLLLLLLLLLLLLLLLLLLLLLLSLLSSSSSCCCCCSSSSSSS..
CLLLLLLLLLLLLLLLLLLLLLLLLLLLLLLLLSSCSSSSSSSCCSSLLLLLLLLLLLLLLLLLLLLLLLLLLLLLLLLLLLLLLLLLLLLLLLLLLLLLLSSSSSSSSSSCCCCSSSSSS.....SS
CLLLLLLLLLLLLLLLLLLLLLLLLLLLLLLLSSCCSSSSSSSSCSSSLLLLLLLLLLLLLLLLLLLLLLLLLLLLLLLLLLLLLLLLLLLLLLLLLSSSSSSSCCCCCCCCSSSS.........SSS
CLLLLLLLLLLLLLLLLLLLLLLLLLLLLLLLSSCSSSSSSSSSCCSSLLLLLLLLLLLLLLLLLLLLLLLLLLLLLLLLLLLLLLLLLLLLLLSSSCCCCCCCCSSCCSSSS..SS....SSS.SSS
CLLLLLLLLLLLLLLLLLLLLLLLLLLLLLLSSCCSSS...SSSSCCSSSSSSSLLLLLLLLLLLLLLLLLLLLLLLLLLLLLLLLLLLLLLSSSSCCSSSSSSSSSSSSSSSSSSSSSSSSS....S
CLLLLLLLLLLLLLLLLLLLLLLLLLLLLLSSCCSSS....SSSSSCCSSSSSSSSSSSLLLLLLLLLLLLLLLSSSSSLLLLSSSSSSSSSSCCCCSSSSS.SSSSSSSSSSSSSSSSSS....SSS
CSLLLLLLLLLLLLLLLLLLLLLLLLLLLSSCCSSSSS......SSSCCCCCCSSSSSSSSSSSLLLLLLLSSSSSSSSSSSSSSSSSSSCCCCSSSSS...SSSSSSSSSSSSSSSSSSSSSSSSS.
CSLLLLLLLLLLLLLLLLLLLLLLSLLLSSSCSSSSS....SS..SSSSSSSCCCCCSSSSSSSSSSSSSSSCCCCCCCSSSSSSSCCCCCSSSSSSSSS.SSSSSSSSSSSSSSSSSSSSS......
CSLSSSSSSSLLLSSSSSSLLSSSSSSSSSCCSSSSSSSSSSS....SSSSSSSSSCCCCCCCCCSSSSCCCCSSSSSCCCCCCCCCSSSSSSSSSSSSS.SSSSSSSSSSSSSSSSSSSSS......
CSSSSSSSSSSSSSSSSSSSSSSSSSSSCCCSSSSSSSSSSS....SSSSSSSSSSSSSSSSSSCCCCCCSSSSSSSSSSSSSSSSSS.............SSSSSSSSSSSSSSSSSSSS..SSSSS
CCCSSSSSSSSCCCCCCCCSCCCCCCCCCSSSS.SSSSSSSS........SSSSSSSSSSSSSSSSSSSSSSSSSSSSSSSSSSSSSS....SSSSSSSS.SSSSSSSSSSSSSSSSSSSSSSSSSSS
SSCCCCCCCCCCSSSSSSCCCSSSSSSSSSSS..SSSSSSS............SSSSSSSSSSSSSSSSSSSSSSSSSSSSSSSSSS.....SSSSSSSS..SSSSSSSSSSSSSSSSSSSSS...SS
SSSSSSSSSSSSSSSSSSSSSSSSSSSSSSS.S.SSSSSSSSS.SS.......SSS......S..SSSSSSSS..............................SSSSSSSSSSSSSSS......S.SS
SSSSSSSSSSSSSSSSSSSSSSSSSSS........SSSSSSS.SSSSSSSSSS.S.....SSSS.SSSSSSSSSSSSSS.........................SSSSSSSSSSSS......SSSSSS
................................................................................................................................
................................................................................................................................
................................................................................................................................
................................................................................................................................
................................................................................................................................
................................................................................................................................
................................................................................................................................
................................................................................................................................
................................................................................................................................
................................................................................................................................
................................................................................................................................
................................................................................................................................
................................................................................................................................
................................................................................................................................
................................................................................................................................
................................................................................................................................
................................................................................................................................
................................................................................................................................
................................................................................................................................
................................................................................................................................
................................................................................................................................
................................................................................................................................
................................................................................................................................
................................................................................................................................
................................................................................................................................
................................................................................................................................
................................................................................................................................
................................................................................................................................
................................................................................................................................
................................................................................................................................
................................................................................................................................
................................................................................................................................
................................................................................................................................
................................................................................................................................
................................................................................................................................
................................................................................................................................
................................................................................................................................
................................................................................................................................
................................................................................................................................
................................................................................................................................
................................................................................................................................
................................................................................................................................
................................................................................................................................
................................................................................................................................
................................................................................................................................
................................................................................................................................
................................................................................................................................
................................................................................................................................
................................................................................................................................
................................................................................................................................
................................................................................................................................
................................................................................................................................
................................................................................................................................
................................................................................................................................
................................................................................................................................
................................................................................................................................
................................................................................................................................
................................................................................................................................
................................................................................................................................
................................................................................................................................
................................................................................................................................
................................................................................................................................
................................................................................................................................
................................................................................................................................
