................................................................................................................................
................................................................................................................................
................................................................................................................................
................................................................................................................................
................................................................................................................................
................................................................................................................................
................................................................................................................................
................................................................................................................................
................................................................................................................................
........................................SSSSSSS.................................................................................
......................................SSSSSSSSSS................................................................................
.....................................SSSSSSSSSSSS...............................................................................
....................................SSSSSSSSSSSSSS..............................................................................
....................................SSSSSSSLLSSSSS..............................................................................
....................................SSSSSSSLSSSSSS..............................................................................
....................................SSSSSLLLSSSSS...............................................................................
....................................SSSSSSSSSSSSS...............................................................................
.....................................SSSSSSSSSSS................................................................................
......................................SSSSSSSS..................................................................................
.......................................SSSSS....................................................................................
................................................................................................................................
................................................................................................................................
..............................................................................................SSSSSS............................
.............................................................................................SSSSSSSS...........................
............................................................................................SSSSSSSSSS..........................
............................................................................................SSSSSSSSSSS.........................
............................................................................................SSSSSSSSSSSS........................
...........................................................................................SSSSSSLSSSSSSS.......................
..........................................................................................SSSSSSSLLSSSSSSS......................
..........................................................................................SSSSSSSLLLSSSSSS......................
......................................SSSSS..............................................SSSSSSLLLLLSSSSSS......................
.....................................SSSSSSSS............................................SSSSSLLLLLLLSSSSS......................
.................................SSSSSSSSSSSSSSSSS......................................SSSSSSLLLLLLLSSSSS......................
..............................SSSSSSSSSSSSSSSSSSSSSSSS..................................SSSSSSLLLLLLLSSSSSS.....................
............................SSSSSSSSSSSSSSSSSSSSSSSSSSSS................................SSSSSLLLLLLLLSSSSSS.....................
..........................SSSSSSSSSSSLLLLSSSSSSSSSSSSSSSS...............................SSSSLLLLLLLLLSSSSS......................
..........................SSSSSSSSSSLLLLLLSLSSSSSSSSSSSSSS..............................SSSSSLLLLLLLLSSSSS......................
.........................SSSSSSSLLLLLLLLLLLLLSSSLLLSSSSSSS..............................SSSSSLLLLLLLSSSSSS......................
.........................SSSSSLLLLLLLLLLLLLLLLLLLLLLSSSSSSS...............SSSSSSSS......SSSSSSLLLLLSSSSSSS......................
.........................SSSSSSLLLLLLLLLLLLLLLLLLLLLLSSSSSSSS............SSSSSSSSSS......SSSSSLLLLLSSSSSS.......................
.........................SSSSSSLLLLLLLLLLLLLLLLLLLLLLLSSSSSSSSSSSSSS...SSSSSSSSSSSSS......SSSSSSLLLSSSSSS.......................
..........................SSSSSLLLLLLLLLLLLLLLLLLLLLLLSSSSSSSSSSSSSSS..SSSSSSSSSSSSSS.....SSSSSSSLLSSSSSS.......................
..........................SSSSSLLLLLLLLLLLLLLLLLLLLLLLLLSLSSSSSSSSSSSSSSSSSSSSSSSSSSS......SSSSSSSSSSSSSS.......................
..........................SSSSSSLLLLLLLLLLLLLLLLLLLLLLLLLLLSSSSSSSSSSSSSSSSSLLLSSSSSS......SSSSSSSSSSSSS........................
..........................SSSSLLLLLLLLLLLLLLLLLLLLLLLLLLLLLLLLLLSSSSSSSSSSLLLLLLSSSSS.......SSSSSSSSSSSS........................
..........................SSSSLLLLLLLLLLLLLLLLLLLLLLLLLLLLLLLLLLLLSSSSSSSSLLLLLLSSSSS..........SSSSSSSS.........................
..........................SSSSLLLLLLLLLLLLLLLLLLLLLLLLLLLLLLLLLLLLLSSSSSSSLLLLLLSSSSS..............SSS..........................
..........................SSSSLLLLLLLLLLLLLLLLLLLLLLLLLLLLLLLLLLLLLLSSSSSSLLLLLLSSSSS...........................................
..........................SSSSLLLLLLLLLLLLLLLLLLLLLLLLLLLLLLLLLLLLLLLLSSLLLLLLLSSSSSS...........................................
.........................SSSSSSLLLLLLLLLLSSSSSSSLLLLLLLLLLLLLLLLLLLLLLLLLLLLLLLSSSSSS...........................................
.........................SSSSSSLLLLLSLSSSSSSSSSSSLLLLLLLLLLLLLLLLLLLLLLLLLLLLLLLSSSSS...........................................
..........................SSSSSSSLLSSSSSSSSSSSSSSSLLLLLLLLLLLLLLLLLLLLLLLLLLLLLLSSSSSS..........................................
..........................SSSSSSSSSSSSSSSSSSSSSSSSLLLLLLLLLLLLLLLLLLLLLLLLLLLLLLSSSSSS..........................................
...........................SSSSSSSSSSSSSSSSSSSSSSSLLLLLLLLLLLLLLLLLLLLLLLLLLLLLLSSSSSS..........................................
.............................SSSSSSSSSSSSSS...SSSSLLLLLLLLLLLLLLLLLLLLLLLLLLLLLLSSSSSSSS........................................
..............................SSSSSSSS.......SSSSSLLLLLLLLLLLLLLLLLLLLLLLLLLLLLLLSSSSSSSS.......................................
................................SSSS.........SSSSSSLLLLLLLLLLLLLLLLLLLLLLLLLLLLLLLSSSSSSS.......................................
..............................................SSSSSSLLLLLLLLLLLLLLLLLLLLLLLLLLLLLLLLSSSSSS......................................
..............................................SSSSSSLLLLLLLLLLLLLLLLLLLLLLLLLLLLLLLLSSSSSS......................................
...............................................SSSSSSLLLLLLLLLLLLLLLLLLLLLLLLLLLLLSSSSSSS.......................................
................................................SSSSSSLLLLLLLLLLLLLLLLLLLLLLLLLLSSSSSSSSS.......................................
.................................................SSSSSSLLLLLLLLLLLLLLLLLLLLLLLLSSSSSSSSSS.......................................
..................................................SSSSSSSSLLLLSSSSSLLLLLLLLLLLLSSSSSSSSS........................................
...................................................SSSSSSSSSSSSSSSSSLLLLLLLLLLLSSSSSSS..........................................
....................................................SSSSSSSSSSSSSSSSLLLLLLLLLSSSSSSS............................................
.....................................................SSSSSSSSSSSSSSSLLLLLLLLSSSSSSSS............................................
......................................................SSSSSSSSSSSSSSSLLLLLLLSSSSSSS.............................................
..................................................SSSSSSSSSSSS.SSSSSSLLLLLLLSSSSSS..............................................
...............................................SSSSSSSSSSS......SSSSSLLLLLLLLSSSS...............................................
.............................................SSSSSSSSSSSSS.....SSSSSLLLLSSLSSSSSS...............................................
...........................................SSSSSSSSSSSSSSSS....SSSSSLLLSSSSSSSSSS...............................................
...........................................SSSSSSSSSSSSSSSS....SSSSSSSSSSSSSSSSSS...............................................
..........................................SSSSSSSSLLLLSSSSS....SSSSSSSSSSSSSSSSS................................................
........................................SSSSSSSSLLLLLSSSSS......SSSSSSSSSSSSSSS.................................................
........................................SSSSSSSLLLLSSSSSSS.......SSSSSSSS.......................................................
........................................SSSSSSLLLLLSSSSSSS........S.............................................................
........................................SSSSSLLLLLSSSSSSS.......................................................................
........................................SSSSLLLLLLSSSSSS...........SSSSSS.......................................................
........................................SSSSLLLLLSSSSSS...........SSSSSSSS......................................................
........................................SSSSSSLLSSSSSS..........SSSSSSSSSSS.....................................................
........................................SSSSSSSSSSSSS..........SSSSSSSSSSSS.....................................................
.........................................SSSSSSSSSSSS..........SSSSSSSSSSSSS....................................................
.........................................SSSSSSSSSSS...........SSSSSSLLSSSSS....................................................
..........................................SSSSSSSSSS...........SSSSSSLLSSSSS....................................................
............................................SSSSSSS............SSSSSLLLSSSSS....................................................
...............................................................SSSSSLLLSSSSS....................................................
...............................................................SSSSSLLLSSSSS....................................................
...............................................................SSSSSSLSSSSSS....................................................
................................................................SSSSSSSSSSS.....................................................
.................................................................SSSSSSSSSS.....................................................
..................................................................SSSSSSSS......................................................
....................................................................SSSS........................................................
................................................................................................................................
................................................................................................................................
................................................................................................................................
................................................................................................................................
................................................................................................................................
................................................................................................................................
................................................................................................................................
................................................................................................................................
................................................................................................................................
................................................................................................................................
................................................................................................................................
................................................................................................................................
................................................................................................................................
................................................................................................................................
................................................................................................................................
................................................................................................................................
................................................................................................................................
................................................................................................................................
................................................................................................................................
................................................................................................................................
................................................................................................................................
................................................................................................................................
................................................................................................................................
................................................................................................................................
................................................................................................................................
................................................................................................................................
................................................................................................................................
................................................................................................................................
................................................................................................................................
................................................................................................................................
................................................................................................................................
................................................................................................................................
................................................................................................................................
................................................................................................................................
................................................................................................................................
................................................................................................................................
