................................................................................................................................
................................................................................................................................
................................................................................................................................
................................................................................................................................
................................................................................................................................
................................................................................................................................
................................................................................................................................
................................................................................................................................
................................................................................................................................
................................................................................................................................
................................................................................................................................
................................................................................................................................
................................................................................................................................
................................................................................................................................
................................................................................................................................
................................................................................................................................
................................................................................................................................
................................................................................................................................
................................................................................................................................
................................................................................................................................
................................................................................................................................
................................................................................................................................
................................................................................................................................
................................................................................................................................
................................................................................................................................
................................................................................................................................
................................................................................................................................
................................................................................................................................
................................................................................................................................
................................................................................................................................
................................................................................................................................
................................................................................................................................
................................................................................................................................
................................................................................................................................
................................................................................................................................
................................................................................................................................
................................................................................................................................
................................................................................................................................
.......................................................SSSSSSSSSSSSSSSSSSSSS....................................................
....................................................SSSSSSSSSSSSSSSSSSSSSSSSS...................................................
.................................................SSSSSSSSSSSSSSSSSSSSSSSSSSSS...................................................
...............................................SSSSSSSSSSSSSSSSSSSSSSSSSSSSSSS..................................................
.............................................SSSSSSSSSSSSSSSSSSSSSSSSSSSSSSSSSS.................................................
....................................SSSSSSSSSSSSSSSSSSSSSSSSSSSSSSSSSSSSSSSSSSSS................................................
...................................SSSSSSSSSSSSSSSSSSSSCCSSSSSSSSSSSSSSSSSSSSSSSS...............................................
..................................SSSSSSSSSSSSSSSSSSSSSCLCCSSSSSSSSSSSSSSSSSSSSSS...............................................
..................................SSSSSSSSSSSSSSSSSSSSSCCLCCSSSSSSSSSSSSSSSSSSSSS...............................................
..................................SSSSSSSSSSSSSSSSSSSSSSSCCCSSSSSSSSSSSSSSSSSSSSSS..............................................
..................................SSSSSSSSSSSSSSSSSSSSSSSSSSCLCSSSSSSSSSSSSSSSSSSSSS............................................
...................................SSSSSSSSSSSSSSSSSSSSSSSSSLLLCCSSSSSSSSSSSSSSSSSSSS...........................................
....................................SSSSSSSSSSSSSSSSSSSSSSSSCLLLLCCSSSSSSSSSSSSSSSSS............................................
.....................................SSSSSSSSSSSSSSSSSSSSSSSCCLLLLLCSSSSSSSSSSSSSSSSS...........................................
.......................................SSSSSSSSSSSSSSSSSSSSSSCLLLLLLCSSSSSSSCCLLLCSSSS..........................................
........................................SSSSSSSSSSSSSSSSSSSSSSCLLLLLLCSCCLLLLLLLLLCSSS..........................................
.........................................SSSSSSSSSSSSSSSSSSSSSSLLLLLLCSLLLLLLLLLLLCSSSS.........................................
....................................SSSS..SSSSSSSSSSSSSSSSSSSSSCCSCCLCSLLLLLLLLLLLCSSSSS........................................
....................................SSSSSSSSSSSSSSSSSSSSSSSSSSSSSSSSCSSCLLLCSSSLLLCSSSSS........................................
....................................SSSSSSSSSSSSSSSSSSSSSSSSSSSSSSSSSSSCLLCSSSCLLLCSSSSSS.......................................
....................................SSSSSSSCSSSSSSSSSSSSSSSSSSSSSSSSSSSSSSSSSCLLLLCSSSSSS.......................................
.....................................SSSSSCLCSSSSSSSSSSSSSSSSSSSSSSSSSSSSSSSSCLLLLCSSSSSS.......................................
......................................SSSSCLLCSSSSSSSSSSSSSSSSSSSSSSSSSSSSSSSLLLLLCSSSSSSS......................................
......................................SSSSSCLLCSSSSSSSSSSSSSSSSSSSSSSSSSSSSSSCLLLLLCSSSSSS......................................
.......................................SSSSCCLLSSSSSSSSSSSSSSSSSSSSSSSSSSSSSSCLLLLLCSSSSSS......................................
........................................SSSSSCCCCCCCSSSSSSSSSSSSSSSSSSSSSSSSSSCLLLLLCSSSSS......................................
........................................SSSSSSSCLLLLCCSSSSSSSSSSSSSSSSSSSSSSSSSCLLLLLCSSSS......................................
........................................SSSSSSSSCLLLLLCSSSSSSSSSSSSSSSSSSSSSSSSCLLLLLCSSSSS.....................................
........................................SSSSSSSSSSCCLLCSSSSSSSSSSSSSSSSSSSSSSSSCLLLLLLCSSSS.....................................
.........................................SSSSSSSSSSSCCCCCSSSSSSSSSSSSSSSSSSSSSSCLLLLLLCSSSS.....................................
..........................................SSSSSSSSSSSSCLLCSSSSSSSSSSSSSSSSSSSSSSCLLLLLLSSSS.....................................
...........................................SSSSSSSSSSSCLLLLCCSSSSSSSSSSSSSSSSSSSSCLLLLLCSSS.....................................
.............................................SSSSSSSSSSCCLLLLLLLLCCSSSSSSSSSSSCCSSLLLLLCSSS.....................................
................................................SSSSSSSSSCCLLLLLLLLCSSSSSSSSSSCCSSCLLLLCSSSS....................................
..................................................SSSSSSSSSCCCCLLLLLCCCCSSSSSSSSSSCLLLLCSSSS....................................
...................................................SSSSSSSSSSSSSCCLLLLLLLCCCCCCCCCLLLLLCSSSS....................................
.....................................................SSSSSSSSSSSSSCCLLLLLLLLLLLLLLLLLLLCSSSS....................................
..........................................................SSSSSSSSSSCCCLLLLLLLLLLLLLLLLCSSSS....................................
.............................................................SSSSSSSSSSCCLLLLLLLLLLLLLLCSSSS....................................
..............................................................SSSSSSSSSSSSCCLLLLLLLLLLLCSSSS....................................
...............................................................SSSSSSSSSSSSSSCCLLLLLLLLCSSSS....................................
.................................................................SSSSSSSSSSSSSSSCCLLLLLCSSSS....................................
...................................................................SSSSSSSSSSSSSSSCLLLLLSSSS....................................
.....................................................................SSSSSSSSSSSSSSCCLLLCSSS....................................
......................................................................SSSSSSSSSSSSSSSCCCSSS.....................................
........................................................................SSSSSSSSSSSSSSSSSS......................................
...........................................................................SSSSSSSSSSSSSS.......................................
..............................................................................SSSSSSSSSS........................................
...................................................................................SSS..........................................
................................................................................................................................
................................................................................................................................
................................................................................................................................
................................................................................................................................
................................................................................................................................
................................................................................................................................
................................................................................................................................
................................................................................................................................
................................................................................................................................
................................................................................................................................
................................................................................................................................
................................................................................................................................
................................................................................................................................
................................................................................................................................
................................................................................................................................
................................................................................................................................
................................................................................................................................
................................................................................................................................
................................................................................................................................
................................................................................................................................
................................................................................................................................
................................................................................................................................
................................................................................................................................
................................................................................................................................
................................................................................................................................
................................................................................................................................
................................................................................................................................
................................................................................................................................
................................................................................................................................
................................................................................................................................
................................................................................................................................
................................................................................................................................
................................................................................................................................
................................................................................................................................
................................................................................................................................
................................................................................................................................
................................................................................................................................
................................................................................................................................
................................................................................................................................
................................................................................................................................
................................................................................................................................
